"filename", "language", "Dart", "comment", "blank", "total"
"g:\codecanyon-PCAdfcae-SwiftTech-multivendor-ecommerce-complete-ecommerce-mobile-app-web-and-admin-panel\Wave Mall\lib\basewidget\amount_widget.dart", "Dart", 17, 0, 4, 21
"g:\codecanyon-PCAdfcae-SwiftTech-multivendor-ecommerce-complete-ecommerce-mobile-app-web-and-admin-panel\Wave Mall\lib\basewidget\animated_custom_dialog.dart", "Dart", 55, 0, 5, 60
"g:\codecanyon-PCAdfcae-SwiftTech-multivendor-ecommerce-complete-ecommerce-mobile-app-web-and-admin-panel\Wave Mall\lib\basewidget\app_bar.dart", "Dart", 27, 0, 5, 32
"g:\codecanyon-PCAdfcae-SwiftTech-multivendor-ecommerce-complete-ecommerce-mobile-app-web-and-admin-panel\Wave Mall\lib\basewidget\custom_app_bar.dart", "Dart", 54, 0, 9, 63
"g:\codecanyon-PCAdfcae-SwiftTech-multivendor-ecommerce-complete-ecommerce-mobile-app-web-and-admin-panel\Wave Mall\lib\basewidget\custom_button.dart", "Dart", 48, 0, 4, 52
"g:\codecanyon-PCAdfcae-SwiftTech-multivendor-ecommerce-complete-ecommerce-mobile-app-web-and-admin-panel\Wave Mall\lib\basewidget\custom_exit_card.dart", "Dart", 40, 0, 8, 48
"g:\codecanyon-PCAdfcae-SwiftTech-multivendor-ecommerce-complete-ecommerce-mobile-app-web-and-admin-panel\Wave Mall\lib\basewidget\custom_expanded_app_bar.dart", "Dart", 51, 1, 7, 59
"g:\codecanyon-PCAdfcae-SwiftTech-multivendor-ecommerce-complete-ecommerce-mobile-app-web-and-admin-panel\Wave Mall\lib\basewidget\custom_image.dart", "Dart", 20, 0, 4, 24
"g:\codecanyon-PCAdfcae-SwiftTech-multivendor-ecommerce-complete-ecommerce-mobile-app-web-and-admin-panel\Wave Mall\lib\basewidget\custom_loader.dart", "Dart", 62, 0, 10, 72
"g:\codecanyon-PCAdfcae-SwiftTech-multivendor-ecommerce-complete-ecommerce-mobile-app-web-and-admin-panel\Wave Mall\lib\basewidget\custom_search_text_field.dart", "Dart", 100, 0, 9, 109
"g:\codecanyon-PCAdfcae-SwiftTech-multivendor-ecommerce-complete-ecommerce-mobile-app-web-and-admin-panel\Wave Mall\lib\basewidget\custom_search_widget.dart", "Dart", 214, 51, 33, 298
"g:\codecanyon-PCAdfcae-SwiftTech-multivendor-ecommerce-complete-ecommerce-mobile-app-web-and-admin-panel\Wave Mall\lib\basewidget\custom_slider\carousel_controller.dart", "Dart", 107, 24, 22, 153
"g:\codecanyon-PCAdfcae-SwiftTech-multivendor-ecommerce-complete-ecommerce-mobile-app-web-and-admin-panel\Wave Mall\lib\basewidget\custom_slider\carousel_options.dart", "Dart", 119, 77, 32, 228
"g:\codecanyon-PCAdfcae-SwiftTech-multivendor-ecommerce-complete-ecommerce-mobile-app-web-and-admin-panel\Wave Mall\lib\basewidget\custom_slider\carousel_state.dart", "Dart", 14, 18, 11, 43
"g:\codecanyon-PCAdfcae-SwiftTech-multivendor-ecommerce-complete-ecommerce-mobile-app-web-and-admin-panel\Wave Mall\lib\basewidget\custom_slider\custom_slider.dart", "Dart", 320, 7, 45, 372
"g:\codecanyon-PCAdfcae-SwiftTech-multivendor-ecommerce-complete-ecommerce-mobile-app-web-and-admin-panel\Wave Mall\lib\basewidget\custom_slider\utils.dart", "Dart", 9, 13, 2, 24
"g:\codecanyon-PCAdfcae-SwiftTech-multivendor-ecommerce-complete-ecommerce-mobile-app-web-and-admin-panel\Wave Mall\lib\basewidget\custom_textfield.dart", "Dart", 206, 2, 14, 222
"g:\codecanyon-PCAdfcae-SwiftTech-multivendor-ecommerce-complete-ecommerce-mobile-app-web-and-admin-panel\Wave Mall\lib\basewidget\delete_account_bottom_sheet.dart", "Dart", 54, 0, 6, 60
"g:\codecanyon-PCAdfcae-SwiftTech-multivendor-ecommerce-complete-ecommerce-mobile-app-web-and-admin-panel\Wave Mall\lib\basewidget\guest_dialog.dart", "Dart", 44, 0, 10, 54
"g:\codecanyon-PCAdfcae-SwiftTech-multivendor-ecommerce-complete-ecommerce-mobile-app-web-and-admin-panel\Wave Mall\lib\basewidget\image_diaglog.dart", "Dart", 22, 0, 6, 28
"g:\codecanyon-PCAdfcae-SwiftTech-multivendor-ecommerce-complete-ecommerce-mobile-app-web-and-admin-panel\Wave Mall\lib\basewidget\logout_confirm_bottom_sheet.dart", "Dart", 50, 0, 9, 59
"g:\codecanyon-PCAdfcae-SwiftTech-multivendor-ecommerce-complete-ecommerce-mobile-app-web-and-admin-panel\Wave Mall\lib\basewidget\no_internet_screen.dart", "Dart", 58, 0, 6, 64
"g:\codecanyon-PCAdfcae-SwiftTech-multivendor-ecommerce-complete-ecommerce-mobile-app-web-and-admin-panel\Wave Mall\lib\basewidget\not_logged_in_bottom_sheet.dart", "Dart", 46, 0, 10, 56
"g:\codecanyon-PCAdfcae-SwiftTech-multivendor-ecommerce-complete-ecommerce-mobile-app-web-and-admin-panel\Wave Mall\lib\basewidget\not_loggedin_widget.dart", "Dart", 31, 0, 6, 37
"g:\codecanyon-PCAdfcae-SwiftTech-multivendor-ecommerce-complete-ecommerce-mobile-app-web-and-admin-panel\Wave Mall\lib\basewidget\order_place_success_dialog.dart", "Dart", 32, 0, 3, 35
"g:\codecanyon-PCAdfcae-SwiftTech-multivendor-ecommerce-complete-ecommerce-mobile-app-web-and-admin-panel\Wave Mall\lib\basewidget\paginated_list_view.dart", "Dart", 74, 0, 16, 90
"g:\codecanyon-PCAdfcae-SwiftTech-multivendor-ecommerce-complete-ecommerce-mobile-app-web-and-admin-panel\Wave Mall\lib\basewidget\product_filter_dialog.dart", "Dart", 218, 0, 35, 253
"g:\codecanyon-PCAdfcae-SwiftTech-multivendor-ecommerce-complete-ecommerce-mobile-app-web-and-admin-panel\Wave Mall\lib\basewidget\product_shimmer.dart", "Dart", 70, 1, 5, 76
"g:\codecanyon-PCAdfcae-SwiftTech-multivendor-ecommerce-complete-ecommerce-mobile-app-web-and-admin-panel\Wave Mall\lib\basewidget\product_widget.dart", "Dart", 91, 2, 26, 119
"g:\codecanyon-PCAdfcae-SwiftTech-multivendor-ecommerce-complete-ecommerce-mobile-app-web-and-admin-panel\Wave Mall\lib\basewidget\rating_bar.dart", "Dart", 53, 0, 11, 64
"g:\codecanyon-PCAdfcae-SwiftTech-multivendor-ecommerce-complete-ecommerce-mobile-app-web-and-admin-panel\Wave Mall\lib\basewidget\remove_address_bottom_sheet.dart", "Dart", 47, 0, 9, 56
"g:\codecanyon-PCAdfcae-SwiftTech-multivendor-ecommerce-complete-ecommerce-mobile-app-web-and-admin-panel\Wave Mall\lib\basewidget\remove_from_wishlist_bottom_sheet.dart", "Dart", 49, 0, 9, 58
"g:\codecanyon-PCAdfcae-SwiftTech-multivendor-ecommerce-complete-ecommerce-mobile-app-web-and-admin-panel\Wave Mall\lib\basewidget\remove_wish_list_bottom_sheet.dart", "Dart", 46, 0, 9, 55
"g:\codecanyon-PCAdfcae-SwiftTech-multivendor-ecommerce-complete-ecommerce-mobile-app-web-and-admin-panel\Wave Mall\lib\basewidget\search_widget.dart", "Dart", 92, 0, 17, 109
"g:\codecanyon-PCAdfcae-SwiftTech-multivendor-ecommerce-complete-ecommerce-mobile-app-web-and-admin-panel\Wave Mall\lib\basewidget\select_currency_bottom_sheet.dart", "Dart", 83, 0, 13, 96
"g:\codecanyon-PCAdfcae-SwiftTech-multivendor-ecommerce-complete-ecommerce-mobile-app-web-and-admin-panel\Wave Mall\lib\basewidget\select_language_bottom_sheet.dart", "Dart", 85, 0, 10, 95
"g:\codecanyon-PCAdfcae-SwiftTech-multivendor-ecommerce-complete-ecommerce-mobile-app-web-and-admin-panel\Wave Mall\lib\basewidget\show_custom_snakbar.dart", "Dart", 13, 0, 2, 15
"g:\codecanyon-PCAdfcae-SwiftTech-multivendor-ecommerce-complete-ecommerce-mobile-app-web-and-admin-panel\Wave Mall\lib\basewidget\success_dialog.dart", "Dart", 47, 0, 6, 53
"g:\codecanyon-PCAdfcae-SwiftTech-multivendor-ecommerce-complete-ecommerce-mobile-app-web-and-admin-panel\Wave Mall\lib\basewidget\title_row.dart", "Dart", 151, 0, 23, 174
"g:\codecanyon-PCAdfcae-SwiftTech-multivendor-ecommerce-complete-ecommerce-mobile-app-web-and-admin-panel\Wave Mall\lib\basewidget\transaction_filter_bottom_sheet.dart", "Dart", 53, 0, 3, 56
"g:\codecanyon-PCAdfcae-SwiftTech-multivendor-ecommerce-complete-ecommerce-mobile-app-web-and-admin-panel\Wave Mall\lib\data\datasource\remote\dio\dio_client.dart", "Dart", 145, 0, 15, 160
"g:\codecanyon-PCAdfcae-SwiftTech-multivendor-ecommerce-complete-ecommerce-mobile-app-web-and-admin-panel\Wave Mall\lib\data\datasource\remote\dio\logging_interceptor.dart", "Dart", 45, 0, 9, 54
"g:\codecanyon-PCAdfcae-SwiftTech-multivendor-ecommerce-complete-ecommerce-mobile-app-web-and-admin-panel\Wave Mall\lib\data\datasource\remote\exception\api_error_handler.dart", "Dart", 80, 2, 3, 85
"g:\codecanyon-PCAdfcae-SwiftTech-multivendor-ecommerce-complete-ecommerce-mobile-app-web-and-admin-panel\Wave Mall\lib\data\model\api_response.dart", "Dart", 12, 0, 5, 17
"g:\codecanyon-PCAdfcae-SwiftTech-multivendor-ecommerce-complete-ecommerce-mobile-app-web-and-admin-panel\Wave Mall\lib\data\model\error_response.dart", "Dart", 21, 0, 8, 29
"g:\codecanyon-PCAdfcae-SwiftTech-multivendor-ecommerce-complete-ecommerce-mobile-app-web-and-admin-panel\Wave Mall\lib\data\model\response_model.dart", "Dart", 7, 0, 2, 9
"g:\codecanyon-PCAdfcae-SwiftTech-multivendor-ecommerce-complete-ecommerce-mobile-app-web-and-admin-panel\Wave Mall\lib\di_container.dart", "Dart", 138, 4, 6, 148
"g:\codecanyon-PCAdfcae-SwiftTech-multivendor-ecommerce-complete-ecommerce-mobile-app-web-and-admin-panel\Wave Mall\lib\features\address\controllers\address_controller.dart", "Dart", 207, 0, 36, 243
"g:\codecanyon-PCAdfcae-SwiftTech-multivendor-ecommerce-complete-ecommerce-mobile-app-web-and-admin-panel\Wave Mall\lib\features\address\domain\model\address_model.dart", "Dart", 73, 0, 4, 77
"g:\codecanyon-PCAdfcae-SwiftTech-multivendor-ecommerce-complete-ecommerce-mobile-app-web-and-admin-panel\Wave Mall\lib\features\address\domain\model\restricted_zip_model.dart", "Dart", 15, 0, 3, 18
"g:\codecanyon-PCAdfcae-SwiftTech-multivendor-ecommerce-complete-ecommerce-mobile-app-web-and-admin-panel\Wave Mall\lib\features\address\domain\repo\address_repository.dart", "Dart", 113, 0, 20, 133
"g:\codecanyon-PCAdfcae-SwiftTech-multivendor-ecommerce-complete-ecommerce-mobile-app-web-and-admin-panel\Wave Mall\lib\features\address\domain\repo\contracts\address_repository_interface.dart", "Dart", 2, 0, 1, 3
"g:\codecanyon-PCAdfcae-SwiftTech-multivendor-ecommerce-complete-ecommerce-mobile-app-web-and-admin-panel\Wave Mall\lib\features\address\domain\service\address_service.dart", "Dart", 2, 0, 1, 3
"g:\codecanyon-PCAdfcae-SwiftTech-multivendor-ecommerce-complete-ecommerce-mobile-app-web-and-admin-panel\Wave Mall\lib\features\address\views\add_new_address_screen.dart", "Dart", 420, 0, 50, 470
"g:\codecanyon-PCAdfcae-SwiftTech-multivendor-ecommerce-complete-ecommerce-mobile-app-web-and-admin-panel\Wave Mall\lib\features\address\views\address_list_screen.dart", "Dart", 87, 0, 7, 94
"g:\codecanyon-PCAdfcae-SwiftTech-multivendor-ecommerce-complete-ecommerce-mobile-app-web-and-admin-panel\Wave Mall\lib\features\address\views\saved_address_list_screen.dart", "Dart", 61, 0, 7, 68
"g:\codecanyon-PCAdfcae-SwiftTech-multivendor-ecommerce-complete-ecommerce-mobile-app-web-and-admin-panel\Wave Mall\lib\features\address\views\saved_billing_address_list_screen.dart", "Dart", 59, 0, 7, 66
"g:\codecanyon-PCAdfcae-SwiftTech-multivendor-ecommerce-complete-ecommerce-mobile-app-web-and-admin-panel\Wave Mall\lib\features\address\widgets\address_type_widget.dart", "Dart", 18, 0, 2, 20
"g:\codecanyon-PCAdfcae-SwiftTech-multivendor-ecommerce-complete-ecommerce-mobile-app-web-and-admin-panel\Wave Mall\lib\features\address\widgets\country_search_dialog.dart", "Dart", 49, 0, 7, 56
"g:\codecanyon-PCAdfcae-SwiftTech-multivendor-ecommerce-complete-ecommerce-mobile-app-web-and-admin-panel\Wave Mall\lib\features\address\widgets\zip_search_dialog.dart", "Dart", 45, 0, 7, 52
"g:\codecanyon-PCAdfcae-SwiftTech-multivendor-ecommerce-complete-ecommerce-mobile-app-web-and-admin-panel\Wave Mall\lib\features\auth\controllers\auth_controller.dart", "Dart", 371, 1, 72, 444
"g:\codecanyon-PCAdfcae-SwiftTech-multivendor-ecommerce-complete-ecommerce-mobile-app-web-and-admin-panel\Wave Mall\lib\features\auth\controllers\facebook_login_controller.dart", "Dart", 13, 0, 5, 18
"g:\codecanyon-PCAdfcae-SwiftTech-multivendor-ecommerce-complete-ecommerce-mobile-app-web-and-admin-panel\Wave Mall\lib\features\auth\controllers\google_login_controller.dart", "Dart", 12, 0, 3, 15
"g:\codecanyon-PCAdfcae-SwiftTech-multivendor-ecommerce-complete-ecommerce-mobile-app-web-and-admin-panel\Wave Mall\lib\features\auth\domain\models\login_model.dart", "Dart", 18, 0, 4, 22
"g:\codecanyon-PCAdfcae-SwiftTech-multivendor-ecommerce-complete-ecommerce-mobile-app-web-and-admin-panel\Wave Mall\lib\features\auth\domain\models\register_model.dart", "Dart", 33, 0, 4, 37
"g:\codecanyon-PCAdfcae-SwiftTech-multivendor-ecommerce-complete-ecommerce-mobile-app-web-and-admin-panel\Wave Mall\lib\features\auth\domain\models\social_login_model.dart", "Dart", 21, 0, 5, 26
"g:\codecanyon-PCAdfcae-SwiftTech-multivendor-ecommerce-complete-ecommerce-mobile-app-web-and-admin-panel\Wave Mall\lib\features\auth\domain\repositories\auth_repository.dart", "Dart", 281, 6, 52, 339
"g:\codecanyon-PCAdfcae-SwiftTech-multivendor-ecommerce-complete-ecommerce-mobile-app-web-and-admin-panel\Wave Mall\lib\features\auth\domain\repositories\contracts\auth_repository_interface.dart", "Dart", 32, 0, 30, 62
"g:\codecanyon-PCAdfcae-SwiftTech-multivendor-ecommerce-complete-ecommerce-mobile-app-web-and-admin-panel\Wave Mall\lib\features\auth\views\auth_screen.dart", "Dart", 89, 0, 12, 101
"g:\codecanyon-PCAdfcae-SwiftTech-multivendor-ecommerce-complete-ecommerce-mobile-app-web-and-admin-panel\Wave Mall\lib\features\auth\views\forget_password_screen.dart", "Dart", 139, 0, 25, 164
"g:\codecanyon-PCAdfcae-SwiftTech-multivendor-ecommerce-complete-ecommerce-mobile-app-web-and-admin-panel\Wave Mall\lib\features\auth\widgets\code_picker_widget.dart", "Dart", 255, 22, 43, 320
"g:\codecanyon-PCAdfcae-SwiftTech-multivendor-ecommerce-complete-ecommerce-mobile-app-web-and-admin-panel\Wave Mall\lib\features\auth\widgets\mobile_verify_screen.dart", "Dart", 106, 0, 20, 126
"g:\codecanyon-PCAdfcae-SwiftTech-multivendor-ecommerce-complete-ecommerce-mobile-app-web-and-admin-panel\Wave Mall\lib\features\auth\widgets\otp_verification_screen.dart", "Dart", 203, 0, 35, 238
"g:\codecanyon-PCAdfcae-SwiftTech-multivendor-ecommerce-complete-ecommerce-mobile-app-web-and-admin-panel\Wave Mall\lib\features\auth\widgets\reset_password_widget.dart", "Dart", 77, 1, 17, 95
"g:\codecanyon-PCAdfcae-SwiftTech-multivendor-ecommerce-complete-ecommerce-mobile-app-web-and-admin-panel\Wave Mall\lib\features\auth\widgets\sign_in_widget.dart", "Dart", 181, 0, 33, 214
"g:\codecanyon-PCAdfcae-SwiftTech-multivendor-ecommerce-complete-ecommerce-mobile-app-web-and-admin-panel\Wave Mall\lib\features\auth\widgets\sign_up_widget.dart", "Dart", 241, 0, 41, 282
"g:\codecanyon-PCAdfcae-SwiftTech-multivendor-ecommerce-complete-ecommerce-mobile-app-web-and-admin-panel\Wave Mall\lib\features\auth\widgets\social_login_widget.dart", "Dart", 158, 0, 20, 178
"g:\codecanyon-PCAdfcae-SwiftTech-multivendor-ecommerce-complete-ecommerce-mobile-app-web-and-admin-panel\Wave Mall\lib\features\banner\controllers\banner_controller.dart", "Dart", 113, 0, 20, 133
"g:\codecanyon-PCAdfcae-SwiftTech-multivendor-ecommerce-complete-ecommerce-mobile-app-web-and-admin-panel\Wave Mall\lib\features\banner\domain\models\banner_model.dart", "Dart", 49, 0, 5, 54
"g:\codecanyon-PCAdfcae-SwiftTech-multivendor-ecommerce-complete-ecommerce-mobile-app-web-and-admin-panel\Wave Mall\lib\features\banner\domain\repositories\banner_repository.dart", "Dart", 38, 5, 10, 53
"g:\codecanyon-PCAdfcae-SwiftTech-multivendor-ecommerce-complete-ecommerce-mobile-app-web-and-admin-panel\Wave Mall\lib\features\banner\domain\repositories\contracts\banner_repository_interface.dart", "Dart", 3, 0, 2, 5
"g:\codecanyon-PCAdfcae-SwiftTech-multivendor-ecommerce-complete-ecommerce-mobile-app-web-and-admin-panel\Wave Mall\lib\features\banner\widgets\banner_shimmer.dart", "Dart", 17, 0, 3, 20
"g:\codecanyon-PCAdfcae-SwiftTech-multivendor-ecommerce-complete-ecommerce-mobile-app-web-and-admin-panel\Wave Mall\lib\features\banner\widgets\banners_view.dart", "Dart", 65, 0, 14, 79
"g:\codecanyon-PCAdfcae-SwiftTech-multivendor-ecommerce-complete-ecommerce-mobile-app-web-and-admin-panel\Wave Mall\lib\features\banner\widgets\fashion_theme_banner.dart", "Dart", 81, 0, 14, 95
"g:\codecanyon-PCAdfcae-SwiftTech-multivendor-ecommerce-complete-ecommerce-mobile-app-web-and-admin-panel\Wave Mall\lib\features\banner\widgets\single_banner.dart", "Dart", 39, 0, 8, 47
"g:\codecanyon-PCAdfcae-SwiftTech-multivendor-ecommerce-complete-ecommerce-mobile-app-web-and-admin-panel\Wave Mall\lib\features\brand\controllers\brand_controller.dart", "Dart", 71, 0, 15, 86
"g:\codecanyon-PCAdfcae-SwiftTech-multivendor-ecommerce-complete-ecommerce-mobile-app-web-and-admin-panel\Wave Mall\lib\features\brand\domain\models\brand_model.dart", "Dart", 46, 0, 10, 56
"g:\codecanyon-PCAdfcae-SwiftTech-multivendor-ecommerce-complete-ecommerce-mobile-app-web-and-admin-panel\Wave Mall\lib\features\brand\domain\repositories\brand_repository.dart", "Dart", 24, 0, 5, 29
"g:\codecanyon-PCAdfcae-SwiftTech-multivendor-ecommerce-complete-ecommerce-mobile-app-web-and-admin-panel\Wave Mall\lib\features\brand\domain\repositories\contracts\brand_repo_interface.dart", "Dart", 3, 0, 2, 5
"g:\codecanyon-PCAdfcae-SwiftTech-multivendor-ecommerce-complete-ecommerce-mobile-app-web-and-admin-panel\Wave Mall\lib\features\brand\views\all_brand_screen.dart", "Dart", 51, 0, 5, 56
"g:\codecanyon-PCAdfcae-SwiftTech-multivendor-ecommerce-complete-ecommerce-mobile-app-web-and-admin-panel\Wave Mall\lib\features\brand\widgets\brand_view.dart", "Dart", 122, 0, 16, 138
"g:\codecanyon-PCAdfcae-SwiftTech-multivendor-ecommerce-complete-ecommerce-mobile-app-web-and-admin-panel\Wave Mall\lib\features\cart\controllers\cart_controller.dart", "Dart", 257, 0, 56, 313
"g:\codecanyon-PCAdfcae-SwiftTech-multivendor-ecommerce-complete-ecommerce-mobile-app-web-and-admin-panel\Wave Mall\lib\features\cart\domain\models\cart_model.dart", "Dart", 186, 0, 27, 213
"g:\codecanyon-PCAdfcae-SwiftTech-multivendor-ecommerce-complete-ecommerce-mobile-app-web-and-admin-panel\Wave Mall\lib\features\cart\domain\models\chosen_shipping_method.dart", "Dart", 46, 0, 5, 51
"g:\codecanyon-PCAdfcae-SwiftTech-multivendor-ecommerce-complete-ecommerce-mobile-app-web-and-admin-panel\Wave Mall\lib\features\cart\domain\models\shipping_method_model.dart", "Dart", 35, 0, 7, 42
"g:\codecanyon-PCAdfcae-SwiftTech-multivendor-ecommerce-complete-ecommerce-mobile-app-web-and-admin-panel\Wave Mall\lib\features\cart\domain\models\shipping_model.dart", "Dart", 7, 0, 2, 9
"g:\codecanyon-PCAdfcae-SwiftTech-multivendor-ecommerce-complete-ecommerce-mobile-app-web-and-admin-panel\Wave Mall\lib\features\cart\domain\repositories\cart_repository.dart", "Dart", 106, 0, 12, 118
"g:\codecanyon-PCAdfcae-SwiftTech-multivendor-ecommerce-complete-ecommerce-mobile-app-web-and-admin-panel\Wave Mall\lib\features\cart\domain\repositories\contracts\cart_repository_interface.dart", "Dart", 0, 0, 1, 1
"g:\codecanyon-PCAdfcae-SwiftTech-multivendor-ecommerce-complete-ecommerce-mobile-app-web-and-admin-panel\Wave Mall\lib\features\cart\domain\services\cart_service.dart", "Dart", 94, 0, 12, 106
"g:\codecanyon-PCAdfcae-SwiftTech-multivendor-ecommerce-complete-ecommerce-mobile-app-web-and-admin-panel\Wave Mall\lib\features\cart\views\cart_screen.dart", "Dart", 395, 0, 66, 461
"g:\codecanyon-PCAdfcae-SwiftTech-multivendor-ecommerce-complete-ecommerce-mobile-app-web-and-admin-panel\Wave Mall\lib\features\cart\widget\cart_page_shimmer.dart", "Dart", 71, 0, 7, 78
"g:\codecanyon-PCAdfcae-SwiftTech-multivendor-ecommerce-complete-ecommerce-mobile-app-web-and-admin-panel\Wave Mall\lib\features\cart\widget\cart_widget.dart", "Dart", 190, 1, 28, 219
"g:\codecanyon-PCAdfcae-SwiftTech-multivendor-ecommerce-complete-ecommerce-mobile-app-web-and-admin-panel\Wave Mall\lib\features\category\controllers\category_controller.dart", "Dart", 66, 0, 15, 81
"g:\codecanyon-PCAdfcae-SwiftTech-multivendor-ecommerce-complete-ecommerce-mobile-app-web-and-admin-panel\Wave Mall\lib\features\category\domain\model\category_model.dart", "Dart", 168, 0, 15, 183
"g:\codecanyon-PCAdfcae-SwiftTech-multivendor-ecommerce-complete-ecommerce-mobile-app-web-and-admin-panel\Wave Mall\lib\features\category\domain\model\find_what_you_need.dart", "Dart", 96, 0, 13, 109
"g:\codecanyon-PCAdfcae-SwiftTech-multivendor-ecommerce-complete-ecommerce-mobile-app-web-and-admin-panel\Wave Mall\lib\features\category\domain\repo\category_repo.dart", "Dart", 25, 0, 2, 27
"g:\codecanyon-PCAdfcae-SwiftTech-multivendor-ecommerce-complete-ecommerce-mobile-app-web-and-admin-panel\Wave Mall\lib\features\category\domain\repo\category_repo_interface.dart", "Dart", 3, 0, 1, 4
"g:\codecanyon-PCAdfcae-SwiftTech-multivendor-ecommerce-complete-ecommerce-mobile-app-web-and-admin-panel\Wave Mall\lib\features\category\domain\service\category_service.dart", "Dart", 2, 0, 1, 3
"g:\codecanyon-PCAdfcae-SwiftTech-multivendor-ecommerce-complete-ecommerce-mobile-app-web-and-admin-panel\Wave Mall\lib\features\category\domain\service\category_service_interface.dart", "Dart", 2, 0, 2, 4
"g:\codecanyon-PCAdfcae-SwiftTech-multivendor-ecommerce-complete-ecommerce-mobile-app-web-and-admin-panel\Wave Mall\lib\features\category\view\all_category_screen.dart", "Dart", 209, 0, 17, 226
"g:\codecanyon-PCAdfcae-SwiftTech-multivendor-ecommerce-complete-ecommerce-mobile-app-web-and-admin-panel\Wave Mall\lib\features\category\widget\category_shimmer.dart", "Dart", 44, 0, 8, 52
"g:\codecanyon-PCAdfcae-SwiftTech-multivendor-ecommerce-complete-ecommerce-mobile-app-web-and-admin-panel\Wave Mall\lib\features\category\widget\category_view.dart", "Dart", 39, 0, 10, 49
"g:\codecanyon-PCAdfcae-SwiftTech-multivendor-ecommerce-complete-ecommerce-mobile-app-web-and-admin-panel\Wave Mall\lib\features\category\widget\category_widget.dart", "Dart", 34, 0, 3, 37
"g:\codecanyon-PCAdfcae-SwiftTech-multivendor-ecommerce-complete-ecommerce-mobile-app-web-and-admin-panel\Wave Mall\lib\features\chat\domain\model\chat_model.dart", "Dart", 130, 0, 27, 157
"g:\codecanyon-PCAdfcae-SwiftTech-multivendor-ecommerce-complete-ecommerce-mobile-app-web-and-admin-panel\Wave Mall\lib\features\chat\domain\model\message_body.dart", "Dart", 20, 0, 6, 26
"g:\codecanyon-PCAdfcae-SwiftTech-multivendor-ecommerce-complete-ecommerce-mobile-app-web-and-admin-panel\Wave Mall\lib\features\chat\domain\model\message_model.dart", "Dart", 61, 0, 15, 76
"g:\codecanyon-PCAdfcae-SwiftTech-multivendor-ecommerce-complete-ecommerce-mobile-app-web-and-admin-panel\Wave Mall\lib\features\chat\domain\repo\chat_repo.dart", "Dart", 65, 0, 12, 77
"g:\codecanyon-PCAdfcae-SwiftTech-multivendor-ecommerce-complete-ecommerce-mobile-app-web-and-admin-panel\Wave Mall\lib\features\chat\domain\repo\chat_repo_interface.dart", "Dart", 3, 0, 1, 4
"g:\codecanyon-PCAdfcae-SwiftTech-multivendor-ecommerce-complete-ecommerce-mobile-app-web-and-admin-panel\Wave Mall\lib\features\chat\domain\service\chat_service.dart", "Dart", 2, 0, 1, 3
"g:\codecanyon-PCAdfcae-SwiftTech-multivendor-ecommerce-complete-ecommerce-mobile-app-web-and-admin-panel\Wave Mall\lib\features\chat\domain\service\chat_service_interface.dart", "Dart", 2, 0, 2, 4
"g:\codecanyon-PCAdfcae-SwiftTech-multivendor-ecommerce-complete-ecommerce-mobile-app-web-and-admin-panel\Wave Mall\lib\features\chat\provider\chat_provider.dart", "Dart", 174, 0, 40, 214
"g:\codecanyon-PCAdfcae-SwiftTech-multivendor-ecommerce-complete-ecommerce-mobile-app-web-and-admin-panel\Wave Mall\lib\features\chat\view\chat_screen.dart", "Dart", 246, 3, 28, 277
"g:\codecanyon-PCAdfcae-SwiftTech-multivendor-ecommerce-complete-ecommerce-mobile-app-web-and-admin-panel\Wave Mall\lib\features\chat\view\inbox_screen.dart", "Dart", 92, 0, 20, 112
"g:\codecanyon-PCAdfcae-SwiftTech-multivendor-ecommerce-complete-ecommerce-mobile-app-web-and-admin-panel\Wave Mall\lib\features\chat\widget\chat_header.dart", "Dart", 61, 0, 7, 68
"g:\codecanyon-PCAdfcae-SwiftTech-multivendor-ecommerce-complete-ecommerce-mobile-app-web-and-admin-panel\Wave Mall\lib\features\chat\widget\chat_item_widget.dart", "Dart", 76, 0, 14, 90
"g:\codecanyon-PCAdfcae-SwiftTech-multivendor-ecommerce-complete-ecommerce-mobile-app-web-and-admin-panel\Wave Mall\lib\features\chat\widget\chat_shimmer.dart", "Dart", 37, 0, 3, 40
"g:\codecanyon-PCAdfcae-SwiftTech-multivendor-ecommerce-complete-ecommerce-mobile-app-web-and-admin-panel\Wave Mall\lib\features\chat\widget\chat_type_button.dart", "Dart", 43, 0, 5, 48
"g:\codecanyon-PCAdfcae-SwiftTech-multivendor-ecommerce-complete-ecommerce-mobile-app-web-and-admin-panel\Wave Mall\lib\features\chat\widget\inbox_shimmer.dart", "Dart", 45, 0, 4, 49
"g:\codecanyon-PCAdfcae-SwiftTech-multivendor-ecommerce-complete-ecommerce-mobile-app-web-and-admin-panel\Wave Mall\lib\features\chat\widget\message_bubble.dart", "Dart", 75, 0, 12, 87
"g:\codecanyon-PCAdfcae-SwiftTech-multivendor-ecommerce-complete-ecommerce-mobile-app-web-and-admin-panel\Wave Mall\lib\features\chat\widget\search_inbox_widget.dart", "Dart", 86, 1, 16, 103
"g:\codecanyon-PCAdfcae-SwiftTech-multivendor-ecommerce-complete-ecommerce-mobile-app-web-and-admin-panel\Wave Mall\lib\features\checkout\domain\model\order_place_model.dart", "Dart", 22, 0, 13, 35
"g:\codecanyon-PCAdfcae-SwiftTech-multivendor-ecommerce-complete-ecommerce-mobile-app-web-and-admin-panel\Wave Mall\lib\features\checkout\domain\model\selected_shipping_type.dart", "Dart", 24, 0, 5, 29
"g:\codecanyon-PCAdfcae-SwiftTech-multivendor-ecommerce-complete-ecommerce-mobile-app-web-and-admin-panel\Wave Mall\lib\features\checkout\domain\repo\checkout_repo.dart", "Dart", 117, 0, 24, 141
"g:\codecanyon-PCAdfcae-SwiftTech-multivendor-ecommerce-complete-ecommerce-mobile-app-web-and-admin-panel\Wave Mall\lib\features\checkout\provider\checkout_provider.dart", "Dart", 219, 0, 47, 266
"g:\codecanyon-PCAdfcae-SwiftTech-multivendor-ecommerce-complete-ecommerce-mobile-app-web-and-admin-panel\Wave Mall\lib\features\checkout\view\checkout_screen.dart", "Dart", 245, 0, 39, 284
"g:\codecanyon-PCAdfcae-SwiftTech-multivendor-ecommerce-complete-ecommerce-mobile-app-web-and-admin-panel\Wave Mall\lib\features\checkout\view\digital_payment_order_place.dart", "Dart", 223, 1, 52, 276
"g:\codecanyon-PCAdfcae-SwiftTech-multivendor-ecommerce-complete-ecommerce-mobile-app-web-and-admin-panel\Wave Mall\lib\features\checkout\widget\choose_payment_section.dart", "Dart", 80, 0, 10, 90
"g:\codecanyon-PCAdfcae-SwiftTech-multivendor-ecommerce-complete-ecommerce-mobile-app-web-and-admin-panel\Wave Mall\lib\features\checkout\widget\coupon_apply_widget.dart", "Dart", 59, 0, 8, 67
"g:\codecanyon-PCAdfcae-SwiftTech-multivendor-ecommerce-complete-ecommerce-mobile-app-web-and-admin-panel\Wave Mall\lib\features\checkout\widget\coupon_bottom_sheet.dart", "Dart", 109, 0, 21, 130
"g:\codecanyon-PCAdfcae-SwiftTech-multivendor-ecommerce-complete-ecommerce-mobile-app-web-and-admin-panel\Wave Mall\lib\features\checkout\widget\custom_check_box.dart", "Dart", 49, 0, 4, 53
"g:\codecanyon-PCAdfcae-SwiftTech-multivendor-ecommerce-complete-ecommerce-mobile-app-web-and-admin-panel\Wave Mall\lib\features\checkout\widget\guest_mode_info_picker.dart", "Dart", 65, 0, 10, 75
"g:\codecanyon-PCAdfcae-SwiftTech-multivendor-ecommerce-complete-ecommerce-mobile-app-web-and-admin-panel\Wave Mall\lib\features\checkout\widget\guest_user_contact_information.dart", "Dart", 49, 0, 11, 60
"g:\codecanyon-PCAdfcae-SwiftTech-multivendor-ecommerce-complete-ecommerce-mobile-app-web-and-admin-panel\Wave Mall\lib\features\checkout\widget\offline_payment.dart", "Dart", 65, 0, 10, 75
"g:\codecanyon-PCAdfcae-SwiftTech-multivendor-ecommerce-complete-ecommerce-mobile-app-web-and-admin-panel\Wave Mall\lib\features\checkout\widget\payment_method_bottom_sheet.dart", "Dart", 194, 0, 31, 225
"g:\codecanyon-PCAdfcae-SwiftTech-multivendor-ecommerce-complete-ecommerce-mobile-app-web-and-admin-panel\Wave Mall\lib\features\checkout\widget\proced_button.dart", "Dart", 28, 0, 3, 31
"g:\codecanyon-PCAdfcae-SwiftTech-multivendor-ecommerce-complete-ecommerce-mobile-app-web-and-admin-panel\Wave Mall\lib\features\checkout\widget\product_details_widget.dart", "Dart", 71, 0, 8, 79
"g:\codecanyon-PCAdfcae-SwiftTech-multivendor-ecommerce-complete-ecommerce-mobile-app-web-and-admin-panel\Wave Mall\lib\features\checkout\widget\shipping_details_widget.dart", "Dart", 119, 0, 19, 138
"g:\codecanyon-PCAdfcae-SwiftTech-multivendor-ecommerce-complete-ecommerce-mobile-app-web-and-admin-panel\Wave Mall\lib\features\checkout\widget\shipping_method_bottom_sheet.dart", "Dart", 106, 0, 13, 119
"g:\codecanyon-PCAdfcae-SwiftTech-multivendor-ecommerce-complete-ecommerce-mobile-app-web-and-admin-panel\Wave Mall\lib\features\checkout\widget\wallet_payment.dart", "Dart", 63, 0, 9, 72
"g:\codecanyon-PCAdfcae-SwiftTech-multivendor-ecommerce-complete-ecommerce-mobile-app-web-and-admin-panel\Wave Mall\lib\features\compare\domain\model\attribute_model.dart", "Dart", 14, 0, 5, 19
"g:\codecanyon-PCAdfcae-SwiftTech-multivendor-ecommerce-complete-ecommerce-mobile-app-web-and-admin-panel\Wave Mall\lib\features\compare\domain\model\compare_model.dart", "Dart", 37, 0, 11, 48
"g:\codecanyon-PCAdfcae-SwiftTech-multivendor-ecommerce-complete-ecommerce-mobile-app-web-and-admin-panel\Wave Mall\lib\features\compare\domain\repo\compare_repo.dart", "Dart", 48, 0, 7, 55
"g:\codecanyon-PCAdfcae-SwiftTech-multivendor-ecommerce-complete-ecommerce-mobile-app-web-and-admin-panel\Wave Mall\lib\features\compare\domain\repo\compare_repo_interface.dart", "Dart", 3, 0, 2, 5
"g:\codecanyon-PCAdfcae-SwiftTech-multivendor-ecommerce-complete-ecommerce-mobile-app-web-and-admin-panel\Wave Mall\lib\features\compare\domain\service\compare_service.dart", "Dart", 2, 0, 1, 3
"g:\codecanyon-PCAdfcae-SwiftTech-multivendor-ecommerce-complete-ecommerce-mobile-app-web-and-admin-panel\Wave Mall\lib\features\compare\domain\service\compare_service_interface.dart", "Dart", 2, 0, 2, 4
"g:\codecanyon-PCAdfcae-SwiftTech-multivendor-ecommerce-complete-ecommerce-mobile-app-web-and-admin-panel\Wave Mall\lib\features\compare\provider\compare_provider.dart", "Dart", 71, 0, 18, 89
"g:\codecanyon-PCAdfcae-SwiftTech-multivendor-ecommerce-complete-ecommerce-mobile-app-web-and-admin-panel\Wave Mall\lib\features\compare\view\compare_product_screen.dart", "Dart", 279, 0, 42, 321
"g:\codecanyon-PCAdfcae-SwiftTech-multivendor-ecommerce-complete-ecommerce-mobile-app-web-and-admin-panel\Wave Mall\lib\features\compare\widget\custom_top_sheet.dart", "Dart", 26, 0, 2, 28
"g:\codecanyon-PCAdfcae-SwiftTech-multivendor-ecommerce-complete-ecommerce-mobile-app-web-and-admin-panel\Wave Mall\lib\features\contact_us\contact_us.dart", "Dart", 120, 0, 13, 133
"g:\codecanyon-PCAdfcae-SwiftTech-multivendor-ecommerce-complete-ecommerce-mobile-app-web-and-admin-panel\Wave Mall\lib\features\coupon\domain\model\coupon_item_model.dart", "Dart", 115, 0, 18, 133
"g:\codecanyon-PCAdfcae-SwiftTech-multivendor-ecommerce-complete-ecommerce-mobile-app-web-and-admin-panel\Wave Mall\lib\features\coupon\domain\model\coupon_model.dart", "Dart", 92, 0, 5, 97
"g:\codecanyon-PCAdfcae-SwiftTech-multivendor-ecommerce-complete-ecommerce-mobile-app-web-and-admin-panel\Wave Mall\lib\features\coupon\domain\repo\coupon_repo.dart", "Dart", 40, 0, 6, 46
"g:\codecanyon-PCAdfcae-SwiftTech-multivendor-ecommerce-complete-ecommerce-mobile-app-web-and-admin-panel\Wave Mall\lib\features\coupon\domain\repo\coupon_repo_interface.dart", "Dart", 3, 0, 2, 5
"g:\codecanyon-PCAdfcae-SwiftTech-multivendor-ecommerce-complete-ecommerce-mobile-app-web-and-admin-panel\Wave Mall\lib\features\coupon\domain\service\coupon_service.dart", "Dart", 0, 0, 1, 1
"g:\codecanyon-PCAdfcae-SwiftTech-multivendor-ecommerce-complete-ecommerce-mobile-app-web-and-admin-panel\Wave Mall\lib\features\coupon\domain\service\coupon_service_interface.dart", "Dart", 2, 0, 1, 3
"g:\codecanyon-PCAdfcae-SwiftTech-multivendor-ecommerce-complete-ecommerce-mobile-app-web-and-admin-panel\Wave Mall\lib\features\coupon\provider\coupon_provider.dart", "Dart", 96, 0, 22, 118
"g:\codecanyon-PCAdfcae-SwiftTech-multivendor-ecommerce-complete-ecommerce-mobile-app-web-and-admin-panel\Wave Mall\lib\features\coupon\view\coupon_screen.dart", "Dart", 48, 0, 6, 54
"g:\codecanyon-PCAdfcae-SwiftTech-multivendor-ecommerce-complete-ecommerce-mobile-app-web-and-admin-panel\Wave Mall\lib\features\coupon\widget\coupon_item.dart", "Dart", 114, 0, 16, 130
"g:\codecanyon-PCAdfcae-SwiftTech-multivendor-ecommerce-complete-ecommerce-mobile-app-web-and-admin-panel\Wave Mall\lib\features\dashboard\dashboard_screen.dart", "Dart", 128, 0, 32, 160
"g:\codecanyon-PCAdfcae-SwiftTech-multivendor-ecommerce-complete-ecommerce-mobile-app-web-and-admin-panel\Wave Mall\lib\features\deal\domain\model\featured_deal_model.dart", "Dart", 9, 0, 11, 20
"g:\codecanyon-PCAdfcae-SwiftTech-multivendor-ecommerce-complete-ecommerce-mobile-app-web-and-admin-panel\Wave Mall\lib\features\deal\domain\model\flash_deal_model.dart", "Dart", 66, 0, 5, 71
"g:\codecanyon-PCAdfcae-SwiftTech-multivendor-ecommerce-complete-ecommerce-mobile-app-web-and-admin-panel\Wave Mall\lib\features\deal\domain\repo\deal_repo_interface.dart", "Dart", 0, 0, 1, 1
"g:\codecanyon-PCAdfcae-SwiftTech-multivendor-ecommerce-complete-ecommerce-mobile-app-web-and-admin-panel\Wave Mall\lib\features\deal\domain\repo\featured_deal_repo.dart", "Dart", 17, 0, 3, 20
"g:\codecanyon-PCAdfcae-SwiftTech-multivendor-ecommerce-complete-ecommerce-mobile-app-web-and-admin-panel\Wave Mall\lib\features\deal\domain\repo\flash_deal_repo.dart", "Dart", 24, 0, 3, 27
"g:\codecanyon-PCAdfcae-SwiftTech-multivendor-ecommerce-complete-ecommerce-mobile-app-web-and-admin-panel\Wave Mall\lib\features\deal\domain\service\deal_service.dart", "Dart", 2, 0, 1, 3
"g:\codecanyon-PCAdfcae-SwiftTech-multivendor-ecommerce-complete-ecommerce-mobile-app-web-and-admin-panel\Wave Mall\lib\features\deal\domain\service\deal_service_interface.dart", "Dart", 2, 0, 2, 4
"g:\codecanyon-PCAdfcae-SwiftTech-multivendor-ecommerce-complete-ecommerce-mobile-app-web-and-admin-panel\Wave Mall\lib\features\deal\provider\featured_deal_provider.dart", "Dart", 29, 0, 9, 38
"g:\codecanyon-PCAdfcae-SwiftTech-multivendor-ecommerce-complete-ecommerce-mobile-app-web-and-admin-panel\Wave Mall\lib\features\deal\provider\flash_deal_provider.dart", "Dart", 56, 0, 9, 65
"g:\codecanyon-PCAdfcae-SwiftTech-multivendor-ecommerce-complete-ecommerce-mobile-app-web-and-admin-panel\Wave Mall\lib\features\deal\view\featured_deal_screen.dart", "Dart", 20, 0, 2, 22
"g:\codecanyon-PCAdfcae-SwiftTech-multivendor-ecommerce-complete-ecommerce-mobile-app-web-and-admin-panel\Wave Mall\lib\features\deal\view\flash_deal_screen.dart", "Dart", 31, 0, 12, 43
"g:\codecanyon-PCAdfcae-SwiftTech-multivendor-ecommerce-complete-ecommerce-mobile-app-web-and-admin-panel\Wave Mall\lib\features\deal\widget\featured_deal_card.dart", "Dart", 116, 1, 22, 139
"g:\codecanyon-PCAdfcae-SwiftTech-multivendor-ecommerce-complete-ecommerce-mobile-app-web-and-admin-panel\Wave Mall\lib\features\deal\widget\featured_deal_view.dart", "Dart", 54, 0, 9, 63
"g:\codecanyon-PCAdfcae-SwiftTech-multivendor-ecommerce-complete-ecommerce-mobile-app-web-and-admin-panel\Wave Mall\lib\features\deal\widget\flash_deal_card.dart", "Dart", 91, 0, 22, 113
"g:\codecanyon-PCAdfcae-SwiftTech-multivendor-ecommerce-complete-ecommerce-mobile-app-web-and-admin-panel\Wave Mall\lib\features\deal\widget\flash_deals_view.dart", "Dart", 161, 1, 26, 188
"g:\codecanyon-PCAdfcae-SwiftTech-multivendor-ecommerce-complete-ecommerce-mobile-app-web-and-admin-panel\Wave Mall\lib\features\guest\track_order.dart", "Dart", 69, 0, 10, 79
"g:\codecanyon-PCAdfcae-SwiftTech-multivendor-ecommerce-complete-ecommerce-mobile-app-web-and-admin-panel\Wave Mall\lib\features\home\model\more_store_model.dart", "Dart", 67, 0, 7, 74
"g:\codecanyon-PCAdfcae-SwiftTech-multivendor-ecommerce-complete-ecommerce-mobile-app-web-and-admin-panel\Wave Mall\lib\features\home\model\shop_again_from_recent_store_model.dart", "Dart", 68, 0, 11, 79
"g:\codecanyon-PCAdfcae-SwiftTech-multivendor-ecommerce-complete-ecommerce-mobile-app-web-and-admin-panel\Wave Mall\lib\features\home\shimmer\featured_product_shimmer.dart", "Dart", 84, 0, 9, 93
"g:\codecanyon-PCAdfcae-SwiftTech-multivendor-ecommerce-complete-ecommerce-mobile-app-web-and-admin-panel\Wave Mall\lib\features\home\shimmer\flash_deal_shimmer.dart", "Dart", 104, 0, 13, 117
"g:\codecanyon-PCAdfcae-SwiftTech-multivendor-ecommerce-complete-ecommerce-mobile-app-web-and-admin-panel\Wave Mall\lib\features\home\shimmer\latest_product_shimmer.dart", "Dart", 33, 0, 4, 37
"g:\codecanyon-PCAdfcae-SwiftTech-multivendor-ecommerce-complete-ecommerce-mobile-app-web-and-admin-panel\Wave Mall\lib\features\home\shimmer\order_again_shimmer.dart", "Dart", 67, 0, 14, 81
"g:\codecanyon-PCAdfcae-SwiftTech-multivendor-ecommerce-complete-ecommerce-mobile-app-web-and-admin-panel\Wave Mall\lib\features\home\shimmer\order_details_shimmer.dart", "Dart", 69, 0, 35, 104
"g:\codecanyon-PCAdfcae-SwiftTech-multivendor-ecommerce-complete-ecommerce-mobile-app-web-and-admin-panel\Wave Mall\lib\features\home\shimmer\product_details_shimmer.dart", "Dart", 80, 0, 46, 126
"g:\codecanyon-PCAdfcae-SwiftTech-multivendor-ecommerce-complete-ecommerce-mobile-app-web-and-admin-panel\Wave Mall\lib\features\home\shimmer\recommended_product_shimmer.dart", "Dart", 46, 0, 9, 55
"g:\codecanyon-PCAdfcae-SwiftTech-multivendor-ecommerce-complete-ecommerce-mobile-app-web-and-admin-panel\Wave Mall\lib\features\home\shimmer\top_store_shimmer.dart", "Dart", 62, 0, 14, 76
"g:\codecanyon-PCAdfcae-SwiftTech-multivendor-ecommerce-complete-ecommerce-mobile-app-web-and-admin-panel\Wave Mall\lib\features\home\shimmer\transaction_shimmer.dart", "Dart", 26, 0, 3, 29
"g:\codecanyon-PCAdfcae-SwiftTech-multivendor-ecommerce-complete-ecommerce-mobile-app-web-and-admin-panel\Wave Mall\lib\features\home\shimmer\wallet_bonus_shimmer.dart", "Dart", 82, 0, 19, 101
"g:\codecanyon-PCAdfcae-SwiftTech-multivendor-ecommerce-complete-ecommerce-mobile-app-web-and-admin-panel\Wave Mall\lib\features\home\view\aster_theme_home_page.dart", "Dart", 358, 16, 86, 460
"g:\codecanyon-PCAdfcae-SwiftTech-multivendor-ecommerce-complete-ecommerce-mobile-app-web-and-admin-panel\Wave Mall\lib\features\home\view\fashion_theme_home_page.dart", "Dart", 351, 13, 87, 451
"g:\codecanyon-PCAdfcae-SwiftTech-multivendor-ecommerce-complete-ecommerce-mobile-app-web-and-admin-panel\Wave Mall\lib\features\home\view\home_screens.dart", "Dart", 309, 11, 69, 389
"g:\codecanyon-PCAdfcae-SwiftTech-multivendor-ecommerce-complete-ecommerce-mobile-app-web-and-admin-panel\Wave Mall\lib\features\home\widget\announcement.dart", "Dart", 32, 0, 4, 36
"g:\codecanyon-PCAdfcae-SwiftTech-multivendor-ecommerce-complete-ecommerce-mobile-app-web-and-admin-panel\Wave Mall\lib\features\home\widget\aster_theme\find_what_you_need_shimmer.dart", "Dart", 74, 0, 11, 85
"g:\codecanyon-PCAdfcae-SwiftTech-multivendor-ecommerce-complete-ecommerce-mobile-app-web-and-admin-panel\Wave Mall\lib\features\home\widget\aster_theme\find_what_you_need_view.dart", "Dart", 121, 0, 15, 136
"g:\codecanyon-PCAdfcae-SwiftTech-multivendor-ecommerce-complete-ecommerce-mobile-app-web-and-admin-panel\Wave Mall\lib\features\home\widget\aster_theme\more_store_view.dart", "Dart", 28, 0, 4, 32
"g:\codecanyon-PCAdfcae-SwiftTech-multivendor-ecommerce-complete-ecommerce-mobile-app-web-and-admin-panel\Wave Mall\lib\features\home\widget\aster_theme\more_store_widget.dart", "Dart", 91, 0, 10, 101
"g:\codecanyon-PCAdfcae-SwiftTech-multivendor-ecommerce-complete-ecommerce-mobile-app-web-and-admin-panel\Wave Mall\lib\features\home\widget\aster_theme\order_again_view.dart", "Dart", 113, 0, 15, 128
"g:\codecanyon-PCAdfcae-SwiftTech-multivendor-ecommerce-complete-ecommerce-mobile-app-web-and-admin-panel\Wave Mall\lib\features\home\widget\cart_widget_home_page.dart", "Dart", 59, 0, 5, 64
"g:\codecanyon-PCAdfcae-SwiftTech-multivendor-ecommerce-complete-ecommerce-mobile-app-web-and-admin-panel\Wave Mall\lib\features\home\widget\fashion_theme\most_demanded_product.dart", "Dart", 99, 0, 15, 114
"g:\codecanyon-PCAdfcae-SwiftTech-multivendor-ecommerce-complete-ecommerce-mobile-app-web-and-admin-panel\Wave Mall\lib\features\home\widget\fashion_theme\shop_again_from_your_recent_store.dart", "Dart", 22, 0, 4, 26
"g:\codecanyon-PCAdfcae-SwiftTech-multivendor-ecommerce-complete-ecommerce-mobile-app-web-and-admin-panel\Wave Mall\lib\features\home\widget\just_for_you\just_for_you.dart", "Dart", 36, 0, 8, 44
"g:\codecanyon-PCAdfcae-SwiftTech-multivendor-ecommerce-complete-ecommerce-mobile-app-web-and-admin-panel\Wave Mall\lib\features\home\widget\just_for_you\just_for_you_product_card.dart", "Dart", 94, 2, 24, 120
"g:\codecanyon-PCAdfcae-SwiftTech-multivendor-ecommerce-complete-ecommerce-mobile-app-web-and-admin-panel\Wave Mall\lib\features\home\widget\marque_text.dart", "Dart", 51, 0, 7, 58
"g:\codecanyon-PCAdfcae-SwiftTech-multivendor-ecommerce-complete-ecommerce-mobile-app-web-and-admin-panel\Wave Mall\lib\features\home\widget\search_widget_home_page.dart", "Dart", 35, 0, 6, 41
"g:\codecanyon-PCAdfcae-SwiftTech-multivendor-ecommerce-complete-ecommerce-mobile-app-web-and-admin-panel\Wave Mall\lib\features\home\widget\shop_again_from_recent_store_card.dart", "Dart", 80, 0, 7, 87
"g:\codecanyon-PCAdfcae-SwiftTech-multivendor-ecommerce-complete-ecommerce-mobile-app-web-and-admin-panel\Wave Mall\lib\features\home\widget\shop_again_from_recent_store_list_view.dart", "Dart", 27, 0, 3, 30
"g:\codecanyon-PCAdfcae-SwiftTech-multivendor-ecommerce-complete-ecommerce-mobile-app-web-and-admin-panel\Wave Mall\lib\features\location\controllers\location_controller.dart", "Dart", 178, 0, 31, 209
"g:\codecanyon-PCAdfcae-SwiftTech-multivendor-ecommerce-complete-ecommerce-mobile-app-web-and-admin-panel\Wave Mall\lib\features\location\domain\models\place_details_model.dart", "Dart", 206, 0, 28, 234
"g:\codecanyon-PCAdfcae-SwiftTech-multivendor-ecommerce-complete-ecommerce-mobile-app-web-and-admin-panel\Wave Mall\lib\features\location\domain\models\prediction_model.dart", "Dart", 29, 0, 3, 32
"g:\codecanyon-PCAdfcae-SwiftTech-multivendor-ecommerce-complete-ecommerce-mobile-app-web-and-admin-panel\Wave Mall\lib\features\location\domain\repos\contracts\location_repository_interface.dart", "Dart", 2, 0, 1, 3
"g:\codecanyon-PCAdfcae-SwiftTech-multivendor-ecommerce-complete-ecommerce-mobile-app-web-and-admin-panel\Wave Mall\lib\features\location\domain\repos\location_repository.dart", "Dart", 34, 0, 8, 42
"g:\codecanyon-PCAdfcae-SwiftTech-multivendor-ecommerce-complete-ecommerce-mobile-app-web-and-admin-panel\Wave Mall\lib\features\location\domain\service\location_service.dart", "Dart", 2, 0, 1, 3
"g:\codecanyon-PCAdfcae-SwiftTech-multivendor-ecommerce-complete-ecommerce-mobile-app-web-and-admin-panel\Wave Mall\lib\features\location\view\select_location_screen.dart", "Dart", 95, 0, 13, 108
"g:\codecanyon-PCAdfcae-SwiftTech-multivendor-ecommerce-complete-ecommerce-mobile-app-web-and-admin-panel\Wave Mall\lib\features\location\widget\location_search_dialog.dart", "Dart", 55, 0, 3, 58
"g:\codecanyon-PCAdfcae-SwiftTech-multivendor-ecommerce-complete-ecommerce-mobile-app-web-and-admin-panel\Wave Mall\lib\features\loyaltyPoint\domain\model\loyalty_point_model.dart", "Dart", 140, 0, 12, 152
"g:\codecanyon-PCAdfcae-SwiftTech-multivendor-ecommerce-complete-ecommerce-mobile-app-web-and-admin-panel\Wave Mall\lib\features\loyaltyPoint\domain\repo\loyalty_point_repo.dart", "Dart", 28, 0, 4, 32
"g:\codecanyon-PCAdfcae-SwiftTech-multivendor-ecommerce-complete-ecommerce-mobile-app-web-and-admin-panel\Wave Mall\lib\features\loyaltyPoint\domain\service\loyalty_poin_service.dart", "Dart", 2, 0, 1, 3
"g:\codecanyon-PCAdfcae-SwiftTech-multivendor-ecommerce-complete-ecommerce-mobile-app-web-and-admin-panel\Wave Mall\lib\features\loyaltyPoint\domain\service\loyalty_point_service_interface.dart", "Dart", 2, 0, 2, 4
"g:\codecanyon-PCAdfcae-SwiftTech-multivendor-ecommerce-complete-ecommerce-mobile-app-web-and-admin-panel\Wave Mall\lib\features\loyaltyPoint\provider\loyalty_point_provider.dart", "Dart", 65, 0, 17, 82
"g:\codecanyon-PCAdfcae-SwiftTech-multivendor-ecommerce-complete-ecommerce-mobile-app-web-and-admin-panel\Wave Mall\lib\features\loyaltyPoint\view\loyalty_point_screen.dart", "Dart", 75, 0, 6, 81
"g:\codecanyon-PCAdfcae-SwiftTech-multivendor-ecommerce-complete-ecommerce-mobile-app-web-and-admin-panel\Wave Mall\lib\features\loyaltyPoint\widget\how_to_use_dialog.dart", "Dart", 62, 0, 18, 80
"g:\codecanyon-PCAdfcae-SwiftTech-multivendor-ecommerce-complete-ecommerce-mobile-app-web-and-admin-panel\Wave Mall\lib\features\loyaltyPoint\widget\loyalty_point_converter_dialogue.dart", "Dart", 125, 0, 22, 147
"g:\codecanyon-PCAdfcae-SwiftTech-multivendor-ecommerce-complete-ecommerce-mobile-app-web-and-admin-panel\Wave Mall\lib\features\loyaltyPoint\widget\loyalty_point_list.dart", "Dart", 60, 0, 11, 71
"g:\codecanyon-PCAdfcae-SwiftTech-multivendor-ecommerce-complete-ecommerce-mobile-app-web-and-admin-panel\Wave Mall\lib\features\loyaltyPoint\widget\loyalty_point_top_card.dart", "Dart", 79, 0, 10, 89
"g:\codecanyon-PCAdfcae-SwiftTech-multivendor-ecommerce-complete-ecommerce-mobile-app-web-and-admin-panel\Wave Mall\lib\features\loyaltyPoint\widget\loyalty_point_widget.dart", "Dart", 60, 0, 11, 71
"g:\codecanyon-PCAdfcae-SwiftTech-multivendor-ecommerce-complete-ecommerce-mobile-app-web-and-admin-panel\Wave Mall\lib\features\maintenance\maintenance_screen.dart", "Dart", 23, 0, 6, 29
"g:\codecanyon-PCAdfcae-SwiftTech-multivendor-ecommerce-complete-ecommerce-mobile-app-web-and-admin-panel\Wave Mall\lib\features\more\faq_screen.dart", "Dart", 50, 0, 6, 56
"g:\codecanyon-PCAdfcae-SwiftTech-multivendor-ecommerce-complete-ecommerce-mobile-app-web-and-admin-panel\Wave Mall\lib\features\more\more_screen.dart", "Dart", 277, 0, 64, 341
"g:\codecanyon-PCAdfcae-SwiftTech-multivendor-ecommerce-complete-ecommerce-mobile-app-web-and-admin-panel\Wave Mall\lib\features\more\widget\html_view_screen.dart", "Dart", 32, 0, 2, 34
"g:\codecanyon-PCAdfcae-SwiftTech-multivendor-ecommerce-complete-ecommerce-mobile-app-web-and-admin-panel\Wave Mall\lib\features\more\widget\more_header_section.dart", "Dart", 77, 0, 8, 85
"g:\codecanyon-PCAdfcae-SwiftTech-multivendor-ecommerce-complete-ecommerce-mobile-app-web-and-admin-panel\Wave Mall\lib\features\more\widget\more_horizontal_section.dart", "Dart", 64, 0, 10, 74
"g:\codecanyon-PCAdfcae-SwiftTech-multivendor-ecommerce-complete-ecommerce-mobile-app-web-and-admin-panel\Wave Mall\lib\features\notification\domain\model\notification_model.dart", "Dart", 82, 0, 13, 95
"g:\codecanyon-PCAdfcae-SwiftTech-multivendor-ecommerce-complete-ecommerce-mobile-app-web-and-admin-panel\Wave Mall\lib\features\notification\domain\repo\notification_repo.dart", "Dart", 25, 0, 2, 27
"g:\codecanyon-PCAdfcae-SwiftTech-multivendor-ecommerce-complete-ecommerce-mobile-app-web-and-admin-panel\Wave Mall\lib\features\notification\domain\service\notification_service.dart", "Dart", 2, 0, 1, 3
"g:\codecanyon-PCAdfcae-SwiftTech-multivendor-ecommerce-complete-ecommerce-mobile-app-web-and-admin-panel\Wave Mall\lib\features\notification\domain\service\notification_service_interface.dart", "Dart", 2, 0, 1, 3
"g:\codecanyon-PCAdfcae-SwiftTech-multivendor-ecommerce-complete-ecommerce-mobile-app-web-and-admin-panel\Wave Mall\lib\features\notification\provider\notification_provider.dart", "Dart", 32, 0, 7, 39
"g:\codecanyon-PCAdfcae-SwiftTech-multivendor-ecommerce-complete-ecommerce-mobile-app-web-and-admin-panel\Wave Mall\lib\features\notification\view\notification_screen.dart", "Dart", 134, 0, 9, 143
"g:\codecanyon-PCAdfcae-SwiftTech-multivendor-ecommerce-complete-ecommerce-mobile-app-web-and-admin-panel\Wave Mall\lib\features\notification\widget\notification_dialog.dart", "Dart", 42, 0, 9, 51
"g:\codecanyon-PCAdfcae-SwiftTech-multivendor-ecommerce-complete-ecommerce-mobile-app-web-and-admin-panel\Wave Mall\lib\features\offer\offers_screen.dart", "Dart", 64, 0, 7, 71
"g:\codecanyon-PCAdfcae-SwiftTech-multivendor-ecommerce-complete-ecommerce-mobile-app-web-and-admin-panel\Wave Mall\lib\features\offline_payment\domain\model\offline_payment_model.dart", "Dart", 69, 0, 17, 86
"g:\codecanyon-PCAdfcae-SwiftTech-multivendor-ecommerce-complete-ecommerce-mobile-app-web-and-admin-panel\Wave Mall\lib\features\offline_payment\view\offline_payment.dart", "Dart", 128, 0, 18, 146
"g:\codecanyon-PCAdfcae-SwiftTech-multivendor-ecommerce-complete-ecommerce-mobile-app-web-and-admin-panel\Wave Mall\lib\features\offline_payment\widget\offline_card.dart", "Dart", 62, 0, 5, 67
"g:\codecanyon-PCAdfcae-SwiftTech-multivendor-ecommerce-complete-ecommerce-mobile-app-web-and-admin-panel\Wave Mall\lib\features\onboarding\domain\model\onboarding_model.dart", "Dart", 9, 0, 3, 12
"g:\codecanyon-PCAdfcae-SwiftTech-multivendor-ecommerce-complete-ecommerce-mobile-app-web-and-admin-panel\Wave Mall\lib\features\onboarding\domain\repo\onboarding_repo.dart", "Dart", 37, 0, 3, 40
"g:\codecanyon-PCAdfcae-SwiftTech-multivendor-ecommerce-complete-ecommerce-mobile-app-web-and-admin-panel\Wave Mall\lib\features\onboarding\domain\repo\onboarding_repo_interface.dart", "Dart", 3, 0, 2, 5
"g:\codecanyon-PCAdfcae-SwiftTech-multivendor-ecommerce-complete-ecommerce-mobile-app-web-and-admin-panel\Wave Mall\lib\features\onboarding\provider\onboarding_provider.dart", "Dart", 27, 0, 7, 34
"g:\codecanyon-PCAdfcae-SwiftTech-multivendor-ecommerce-complete-ecommerce-mobile-app-web-and-admin-panel\Wave Mall\lib\features\onboarding\view\onboarding_screen.dart", "Dart", 97, 0, 11, 108
"g:\codecanyon-PCAdfcae-SwiftTech-multivendor-ecommerce-complete-ecommerce-mobile-app-web-and-admin-panel\Wave Mall\lib\features\order\domain\model\order_details_model.dart", "Dart", 153, 0, 12, 165
"g:\codecanyon-PCAdfcae-SwiftTech-multivendor-ecommerce-complete-ecommerce-mobile-app-web-and-admin-panel\Wave Mall\lib\features\order\domain\model\order_model.dart", "Dart", 437, 0, 52, 489
"g:\codecanyon-PCAdfcae-SwiftTech-multivendor-ecommerce-complete-ecommerce-mobile-app-web-and-admin-panel\Wave Mall\lib\features\order\domain\model\refund_info_model.dart", "Dart", 58, 0, 8, 66
"g:\codecanyon-PCAdfcae-SwiftTech-multivendor-ecommerce-complete-ecommerce-mobile-app-web-and-admin-panel\Wave Mall\lib\features\order\domain\model\refund_result_model.dart", "Dart", 120, 0, 9, 129
"g:\codecanyon-PCAdfcae-SwiftTech-multivendor-ecommerce-complete-ecommerce-mobile-app-web-and-admin-panel\Wave Mall\lib\features\order\domain\model\review_body.dart", "Dart", 34, 0, 5, 39
"g:\codecanyon-PCAdfcae-SwiftTech-multivendor-ecommerce-complete-ecommerce-mobile-app-web-and-admin-panel\Wave Mall\lib\features\order\domain\model\review_model.dart", "Dart", 184, 0, 10, 194
"g:\codecanyon-PCAdfcae-SwiftTech-multivendor-ecommerce-complete-ecommerce-mobile-app-web-and-admin-panel\Wave Mall\lib\features\order\domain\repo\order_repo.dart", "Dart", 138, 0, 26, 164
"g:\codecanyon-PCAdfcae-SwiftTech-multivendor-ecommerce-complete-ecommerce-mobile-app-web-and-admin-panel\Wave Mall\lib\features\order\domain\repo\order_repo_interface.dart", "Dart", 3, 0, 2, 5
"g:\codecanyon-PCAdfcae-SwiftTech-multivendor-ecommerce-complete-ecommerce-mobile-app-web-and-admin-panel\Wave Mall\lib\features\order\domain\service\order_service.dart", "Dart", 0, 0, 1, 1
"g:\codecanyon-PCAdfcae-SwiftTech-multivendor-ecommerce-complete-ecommerce-mobile-app-web-and-admin-panel\Wave Mall\lib\features\order\domain\service\order_service_interface.dart", "Dart", 2, 0, 1, 3
"g:\codecanyon-PCAdfcae-SwiftTech-multivendor-ecommerce-complete-ecommerce-mobile-app-web-and-admin-panel\Wave Mall\lib\features\order\provider\order_provider.dart", "Dart", 290, 0, 57, 347
"g:\codecanyon-PCAdfcae-SwiftTech-multivendor-ecommerce-complete-ecommerce-mobile-app-web-and-admin-panel\Wave Mall\lib\features\order\view\order_details_screen.dart", "Dart", 223, 0, 88, 311
"g:\codecanyon-PCAdfcae-SwiftTech-multivendor-ecommerce-complete-ecommerce-mobile-app-web-and-admin-panel\Wave Mall\lib\features\order\view\order_screen.dart", "Dart", 74, 0, 18, 92
"g:\codecanyon-PCAdfcae-SwiftTech-multivendor-ecommerce-complete-ecommerce-mobile-app-web-and-admin-panel\Wave Mall\lib\features\order\widget\cal_chat_widget.dart", "Dart", 49, 0, 4, 53
"g:\codecanyon-PCAdfcae-SwiftTech-multivendor-ecommerce-complete-ecommerce-mobile-app-web-and-admin-panel\Wave Mall\lib\features\order\widget\cancel_and_support_center.dart", "Dart", 52, 0, 12, 64
"g:\codecanyon-PCAdfcae-SwiftTech-multivendor-ecommerce-complete-ecommerce-mobile-app-web-and-admin-panel\Wave Mall\lib\features\order\widget\cancel_order_dialog.dart", "Dart", 92, 11, 17, 120
"g:\codecanyon-PCAdfcae-SwiftTech-multivendor-ecommerce-complete-ecommerce-mobile-app-web-and-admin-panel\Wave Mall\lib\features\order\widget\icon_with_text_row.dart", "Dart", 26, 0, 5, 31
"g:\codecanyon-PCAdfcae-SwiftTech-multivendor-ecommerce-complete-ecommerce-mobile-app-web-and-admin-panel\Wave Mall\lib\features\order\widget\order_details_top_portion_widget.dart", "Dart", 58, 0, 5, 63
"g:\codecanyon-PCAdfcae-SwiftTech-multivendor-ecommerce-complete-ecommerce-mobile-app-web-and-admin-panel\Wave Mall\lib\features\order\widget\order_details_widget.dart", "Dart", 232, 2, 50, 284
"g:\codecanyon-PCAdfcae-SwiftTech-multivendor-ecommerce-complete-ecommerce-mobile-app-web-and-admin-panel\Wave Mall\lib\features\order\widget\order_shimmer.dart", "Dart", 63, 0, 3, 66
"g:\codecanyon-PCAdfcae-SwiftTech-multivendor-ecommerce-complete-ecommerce-mobile-app-web-and-admin-panel\Wave Mall\lib\features\order\widget\order_type_button.dart", "Dart", 37, 11, 5, 53
"g:\codecanyon-PCAdfcae-SwiftTech-multivendor-ecommerce-complete-ecommerce-mobile-app-web-and-admin-panel\Wave Mall\lib\features\order\widget\order_widget.dart", "Dart", 86, 0, 17, 103
"g:\codecanyon-PCAdfcae-SwiftTech-multivendor-ecommerce-complete-ecommerce-mobile-app-web-and-admin-panel\Wave Mall\lib\features\order\widget\ordered_product_list.dart", "Dart", 27, 0, 3, 30
"g:\codecanyon-PCAdfcae-SwiftTech-multivendor-ecommerce-complete-ecommerce-mobile-app-web-and-admin-panel\Wave Mall\lib\features\order\widget\payment_info.dart", "Dart", 32, 0, 9, 41
"g:\codecanyon-PCAdfcae-SwiftTech-multivendor-ecommerce-complete-ecommerce-mobile-app-web-and-admin-panel\Wave Mall\lib\features\order\widget\refunded_status_bottom_sheet.dart", "Dart", 204, 0, 77, 281
"g:\codecanyon-PCAdfcae-SwiftTech-multivendor-ecommerce-complete-ecommerce-mobile-app-web-and-admin-panel\Wave Mall\lib\features\order\widget\review_dialog.dart", "Dart", 283, 1, 52, 336
"g:\codecanyon-PCAdfcae-SwiftTech-multivendor-ecommerce-complete-ecommerce-mobile-app-web-and-admin-panel\Wave Mall\lib\features\order\widget\seller_section.dart", "Dart", 56, 0, 6, 62
"g:\codecanyon-PCAdfcae-SwiftTech-multivendor-ecommerce-complete-ecommerce-mobile-app-web-and-admin-panel\Wave Mall\lib\features\order\widget\shipping_and_billing_widget.dart", "Dart", 97, 1, 28, 126
"g:\codecanyon-PCAdfcae-SwiftTech-multivendor-ecommerce-complete-ecommerce-mobile-app-web-and-admin-panel\Wave Mall\lib\features\order\widget\shipping_info.dart", "Dart", 41, 0, 8, 49
"g:\codecanyon-PCAdfcae-SwiftTech-multivendor-ecommerce-complete-ecommerce-mobile-app-web-and-admin-panel\Wave Mall\lib\features\product\domain\model\home_category_product_model.dart", "Dart", 42, 0, 7, 49
"g:\codecanyon-PCAdfcae-SwiftTech-multivendor-ecommerce-complete-ecommerce-mobile-app-web-and-admin-panel\Wave Mall\lib\features\product\domain\model\most_demanded_product_model.dart", "Dart", 38, 0, 4, 42
"g:\codecanyon-PCAdfcae-SwiftTech-multivendor-ecommerce-complete-ecommerce-mobile-app-web-and-admin-panel\Wave Mall\lib\features\product\domain\model\product_details_model.dart", "Dart", 634, 0, 46, 680
"g:\codecanyon-PCAdfcae-SwiftTech-multivendor-ecommerce-complete-ecommerce-mobile-app-web-and-admin-panel\Wave Mall\lib\features\product\domain\model\product_model.dart", "Dart", 415, 0, 60, 475
"g:\codecanyon-PCAdfcae-SwiftTech-multivendor-ecommerce-complete-ecommerce-mobile-app-web-and-admin-panel\Wave Mall\lib\features\product\domain\repo\home_category_product_repo.dart", "Dart", 17, 0, 2, 19
"g:\codecanyon-PCAdfcae-SwiftTech-multivendor-ecommerce-complete-ecommerce-mobile-app-web-and-admin-panel\Wave Mall\lib\features\product\domain\repo\product_details_repo.dart", "Dart", 60, 0, 7, 67
"g:\codecanyon-PCAdfcae-SwiftTech-multivendor-ecommerce-complete-ecommerce-mobile-app-web-and-admin-panel\Wave Mall\lib\features\product\domain\repo\product_repo.dart", "Dart", 160, 1, 24, 185
"g:\codecanyon-PCAdfcae-SwiftTech-multivendor-ecommerce-complete-ecommerce-mobile-app-web-and-admin-panel\Wave Mall\lib\features\product\domain\repo\product_repo_interface.dart", "Dart", 3, 0, 2, 5
"g:\codecanyon-PCAdfcae-SwiftTech-multivendor-ecommerce-complete-ecommerce-mobile-app-web-and-admin-panel\Wave Mall\lib\features\product\domain\repo\search_repo.dart", "Dart", 55, 0, 13, 68
"g:\codecanyon-PCAdfcae-SwiftTech-multivendor-ecommerce-complete-ecommerce-mobile-app-web-and-admin-panel\Wave Mall\lib\features\product\domain\service\product_service.dart", "Dart", 0, 0, 1, 1
"g:\codecanyon-PCAdfcae-SwiftTech-multivendor-ecommerce-complete-ecommerce-mobile-app-web-and-admin-panel\Wave Mall\lib\features\product\domain\service\product_service_interface.dart", "Dart", 0, 0, 1, 1
"g:\codecanyon-PCAdfcae-SwiftTech-multivendor-ecommerce-complete-ecommerce-mobile-app-web-and-admin-panel\Wave Mall\lib\features\product\enums\product.dart", "Dart", 4, 0, 1, 5
"g:\codecanyon-PCAdfcae-SwiftTech-multivendor-ecommerce-complete-ecommerce-mobile-app-web-and-admin-panel\Wave Mall\lib\features\product\provider\home_category_product_provider.dart", "Dart", 38, 0, 10, 48
"g:\codecanyon-PCAdfcae-SwiftTech-multivendor-ecommerce-complete-ecommerce-mobile-app-web-and-admin-panel\Wave Mall\lib\features\product\provider\product_details_provider.dart", "Dart", 170, 0, 27, 197
"g:\codecanyon-PCAdfcae-SwiftTech-multivendor-ecommerce-complete-ecommerce-mobile-app-web-and-admin-panel\Wave Mall\lib\features\product\provider\product_provider.dart", "Dart", 361, 10, 84, 455
"g:\codecanyon-PCAdfcae-SwiftTech-multivendor-ecommerce-complete-ecommerce-mobile-app-web-and-admin-panel\Wave Mall\lib\features\product\provider\search_provider.dart", "Dart", 127, 0, 38, 165
"g:\codecanyon-PCAdfcae-SwiftTech-multivendor-ecommerce-complete-ecommerce-mobile-app-web-and-admin-panel\Wave Mall\lib\features\product\view\brand_and_category_product_screen.dart", "Dart", 62, 1, 11, 74
"g:\codecanyon-PCAdfcae-SwiftTech-multivendor-ecommerce-complete-ecommerce-mobile-app-web-and-admin-panel\Wave Mall\lib\features\product\view\faq_and_review_screen.dart", "Dart", 34, 0, 10, 44
"g:\codecanyon-PCAdfcae-SwiftTech-multivendor-ecommerce-complete-ecommerce-mobile-app-web-and-admin-panel\Wave Mall\lib\features\product\view\product_details_screen.dart", "Dart", 169, 0, 34, 203
"g:\codecanyon-PCAdfcae-SwiftTech-multivendor-ecommerce-complete-ecommerce-mobile-app-web-and-admin-panel\Wave Mall\lib\features\product\view\product_image_screen.dart", "Dart", 102, 0, 14, 116
"g:\codecanyon-PCAdfcae-SwiftTech-multivendor-ecommerce-complete-ecommerce-mobile-app-web-and-admin-panel\Wave Mall\lib\features\product\view\specification_screen.dart", "Dart", 22, 0, 9, 31
"g:\codecanyon-PCAdfcae-SwiftTech-multivendor-ecommerce-complete-ecommerce-mobile-app-web-and-admin-panel\Wave Mall\lib\features\product\view\view_all_product_screen.dart", "Dart", 38, 0, 5, 43
"g:\codecanyon-PCAdfcae-SwiftTech-multivendor-ecommerce-complete-ecommerce-mobile-app-web-and-admin-panel\Wave Mall\lib\features\product\widget\bottom_cart_view.dart", "Dart", 112, 0, 20, 132
"g:\codecanyon-PCAdfcae-SwiftTech-multivendor-ecommerce-complete-ecommerce-mobile-app-web-and-admin-panel\Wave Mall\lib\features\product\widget\cart_bottom_sheet.dart", "Dart", 388, 3, 54, 445
"g:\codecanyon-PCAdfcae-SwiftTech-multivendor-ecommerce-complete-ecommerce-mobile-app-web-and-admin-panel\Wave Mall\lib\features\product\widget\favourite_button.dart", "Dart", 45, 0, 6, 51
"g:\codecanyon-PCAdfcae-SwiftTech-multivendor-ecommerce-complete-ecommerce-mobile-app-web-and-admin-panel\Wave Mall\lib\features\product\widget\featured_product_view.dart", "Dart", 80, 0, 13, 93
"g:\codecanyon-PCAdfcae-SwiftTech-multivendor-ecommerce-complete-ecommerce-mobile-app-web-and-admin-panel\Wave Mall\lib\features\product\widget\home_category_product_view.dart", "Dart", 65, 0, 6, 71
"g:\codecanyon-PCAdfcae-SwiftTech-multivendor-ecommerce-complete-ecommerce-mobile-app-web-and-admin-panel\Wave Mall\lib\features\product\widget\latest_product_view.dart", "Dart", 48, 0, 12, 60
"g:\codecanyon-PCAdfcae-SwiftTech-multivendor-ecommerce-complete-ecommerce-mobile-app-web-and-admin-panel\Wave Mall\lib\features\product\widget\latest_product_widget.dart", "Dart", 105, 1, 24, 130
"g:\codecanyon-PCAdfcae-SwiftTech-multivendor-ecommerce-complete-ecommerce-mobile-app-web-and-admin-panel\Wave Mall\lib\features\product\widget\most_searching_product_list_view.dart", "Dart", 53, 0, 4, 57
"g:\codecanyon-PCAdfcae-SwiftTech-multivendor-ecommerce-complete-ecommerce-mobile-app-web-and-admin-panel\Wave Mall\lib\features\product\widget\product_image_view.dart", "Dart", 170, 0, 20, 190
"g:\codecanyon-PCAdfcae-SwiftTech-multivendor-ecommerce-complete-ecommerce-mobile-app-web-and-admin-panel\Wave Mall\lib\features\product\widget\product_specification_view.dart", "Dart", 48, 0, 13, 61
"g:\codecanyon-PCAdfcae-SwiftTech-multivendor-ecommerce-complete-ecommerce-mobile-app-web-and-admin-panel\Wave Mall\lib\features\product\widget\product_title_view.dart", "Dart", 173, 0, 32, 205
"g:\codecanyon-PCAdfcae-SwiftTech-multivendor-ecommerce-complete-ecommerce-mobile-app-web-and-admin-panel\Wave Mall\lib\features\product\widget\products_view.dart", "Dart", 81, 0, 17, 98
"g:\codecanyon-PCAdfcae-SwiftTech-multivendor-ecommerce-complete-ecommerce-mobile-app-web-and-admin-panel\Wave Mall\lib\features\product\widget\promise_screen.dart", "Dart", 38, 0, 6, 44
"g:\codecanyon-PCAdfcae-SwiftTech-multivendor-ecommerce-complete-ecommerce-mobile-app-web-and-admin-panel\Wave Mall\lib\features\product\widget\recommended_product_view.dart", "Dart", 150, 0, 37, 187
"g:\codecanyon-PCAdfcae-SwiftTech-multivendor-ecommerce-complete-ecommerce-mobile-app-web-and-admin-panel\Wave Mall\lib\features\product\widget\refund_request_bottom_sheet.dart", "Dart", 178, 0, 25, 203
"g:\codecanyon-PCAdfcae-SwiftTech-multivendor-ecommerce-complete-ecommerce-mobile-app-web-and-admin-panel\Wave Mall\lib\features\product\widget\related_product_view.dart", "Dart", 30, 0, 4, 34
"g:\codecanyon-PCAdfcae-SwiftTech-multivendor-ecommerce-complete-ecommerce-mobile-app-web-and-admin-panel\Wave Mall\lib\features\product\widget\review_section.dart", "Dart", 53, 0, 10, 63
"g:\codecanyon-PCAdfcae-SwiftTech-multivendor-ecommerce-complete-ecommerce-mobile-app-web-and-admin-panel\Wave Mall\lib\features\product\widget\review_widget.dart", "Dart", 125, 0, 14, 139
"g:\codecanyon-PCAdfcae-SwiftTech-multivendor-ecommerce-complete-ecommerce-mobile-app-web-and-admin-panel\Wave Mall\lib\features\product\widget\seller_view.dart", "Dart", 143, 0, 19, 162
"g:\codecanyon-PCAdfcae-SwiftTech-multivendor-ecommerce-complete-ecommerce-mobile-app-web-and-admin-panel\Wave Mall\lib\features\product\widget\youtube_video_widget.dart", "Dart", 74, 1, 12, 87
"g:\codecanyon-PCAdfcae-SwiftTech-multivendor-ecommerce-complete-ecommerce-mobile-app-web-and-admin-panel\Wave Mall\lib\features\profile\domain\model\user_info_model.dart", "Dart", 91, 0, 7, 98
"g:\codecanyon-PCAdfcae-SwiftTech-multivendor-ecommerce-complete-ecommerce-mobile-app-web-and-admin-panel\Wave Mall\lib\features\profile\domain\repo\profile_repo.dart", "Dart", 68, 0, 12, 80
"g:\codecanyon-PCAdfcae-SwiftTech-multivendor-ecommerce-complete-ecommerce-mobile-app-web-and-admin-panel\Wave Mall\lib\features\profile\domain\repo\profile_repo_interface.dart", "Dart", 0, 0, 1, 1
"g:\codecanyon-PCAdfcae-SwiftTech-multivendor-ecommerce-complete-ecommerce-mobile-app-web-and-admin-panel\Wave Mall\lib\features\profile\domain\service\profile_service.dart", "Dart", 2, 0, 1, 3
"g:\codecanyon-PCAdfcae-SwiftTech-multivendor-ecommerce-complete-ecommerce-mobile-app-web-and-admin-panel\Wave Mall\lib\features\profile\domain\service\profile_service_interface.dart", "Dart", 2, 0, 1, 3
"g:\codecanyon-PCAdfcae-SwiftTech-multivendor-ecommerce-complete-ecommerce-mobile-app-web-and-admin-panel\Wave Mall\lib\features\profile\provider\profile_provider.dart", "Dart", 90, 0, 23, 113
"g:\codecanyon-PCAdfcae-SwiftTech-multivendor-ecommerce-complete-ecommerce-mobile-app-web-and-admin-panel\Wave Mall\lib\features\profile\view\profile_screen.dart", "Dart", 264, 0, 44, 308
"g:\codecanyon-PCAdfcae-SwiftTech-multivendor-ecommerce-complete-ecommerce-mobile-app-web-and-admin-panel\Wave Mall\lib\features\refer_and_earn\refer_and_earn_screen.dart", "Dart", 85, 0, 15, 100
"g:\codecanyon-PCAdfcae-SwiftTech-multivendor-ecommerce-complete-ecommerce-mobile-app-web-and-admin-panel\Wave Mall\lib\features\refer_and_earn\widgets\refer_hint_view.dart", "Dart", 48, 0, 9, 57
"g:\codecanyon-PCAdfcae-SwiftTech-multivendor-ecommerce-complete-ecommerce-mobile-app-web-and-admin-panel\Wave Mall\lib\features\search\model\suggestion_product_model.dart", "Dart", 21, 0, 8, 29
"g:\codecanyon-PCAdfcae-SwiftTech-multivendor-ecommerce-complete-ecommerce-mobile-app-web-and-admin-panel\Wave Mall\lib\features\search\search_screen.dart", "Dart", 128, 0, 19, 147
"g:\codecanyon-PCAdfcae-SwiftTech-multivendor-ecommerce-complete-ecommerce-mobile-app-web-and-admin-panel\Wave Mall\lib\features\search\widget\partial_matched.dart", "Dart", 156, 0, 14, 170
"g:\codecanyon-PCAdfcae-SwiftTech-multivendor-ecommerce-complete-ecommerce-mobile-app-web-and-admin-panel\Wave Mall\lib\features\search\widget\search_filter_bottom_sheet.dart", "Dart", 150, 0, 28, 178
"g:\codecanyon-PCAdfcae-SwiftTech-multivendor-ecommerce-complete-ecommerce-mobile-app-web-and-admin-panel\Wave Mall\lib\features\search\widget\search_product_widget.dart", "Dart", 79, 0, 14, 93
"g:\codecanyon-PCAdfcae-SwiftTech-multivendor-ecommerce-complete-ecommerce-mobile-app-web-and-admin-panel\Wave Mall\lib\features\setting\settings_screen.dart", "Dart", 68, 0, 15, 83
"g:\codecanyon-PCAdfcae-SwiftTech-multivendor-ecommerce-complete-ecommerce-mobile-app-web-and-admin-panel\Wave Mall\lib\features\shop\domain\model\seller_model.dart", "Dart", 229, 0, 19, 248
"g:\codecanyon-PCAdfcae-SwiftTech-multivendor-ecommerce-complete-ecommerce-mobile-app-web-and-admin-panel\Wave Mall\lib\features\shop\domain\model\top_seller_model.dart", "Dart", 142, 0, 9, 151
"g:\codecanyon-PCAdfcae-SwiftTech-multivendor-ecommerce-complete-ecommerce-mobile-app-web-and-admin-panel\Wave Mall\lib\features\shop\domain\repo\shop_repo.dart", "Dart", 24, 0, 2, 26
"g:\codecanyon-PCAdfcae-SwiftTech-multivendor-ecommerce-complete-ecommerce-mobile-app-web-and-admin-panel\Wave Mall\lib\features\shop\domain\repo\top_seller_repo.dart", "Dart", 16, 0, 2, 18
"g:\codecanyon-PCAdfcae-SwiftTech-multivendor-ecommerce-complete-ecommerce-mobile-app-web-and-admin-panel\Wave Mall\lib\features\shop\domain\service\shop_service.dart", "Dart", 0, 0, 1, 1
"g:\codecanyon-PCAdfcae-SwiftTech-multivendor-ecommerce-complete-ecommerce-mobile-app-web-and-admin-panel\Wave Mall\lib\features\shop\domain\service\shop_service_interface.dart", "Dart", 0, 0, 1, 1
"g:\codecanyon-PCAdfcae-SwiftTech-multivendor-ecommerce-complete-ecommerce-mobile-app-web-and-admin-panel\Wave Mall\lib\features\shop\provider\shop_provider.dart", "Dart", 49, 0, 10, 59
"g:\codecanyon-PCAdfcae-SwiftTech-multivendor-ecommerce-complete-ecommerce-mobile-app-web-and-admin-panel\Wave Mall\lib\features\shop\provider\top_seller_provider.dart", "Dart", 26, 0, 8, 34
"g:\codecanyon-PCAdfcae-SwiftTech-multivendor-ecommerce-complete-ecommerce-mobile-app-web-and-admin-panel\Wave Mall\lib\features\shop\view\all_shop_screen.dart", "Dart", 21, 0, 2, 23
"g:\codecanyon-PCAdfcae-SwiftTech-multivendor-ecommerce-complete-ecommerce-mobile-app-web-and-admin-panel\Wave Mall\lib\features\shop\view\overview_screen.dart", "Dart", 96, 0, 13, 109
"g:\codecanyon-PCAdfcae-SwiftTech-multivendor-ecommerce-complete-ecommerce-mobile-app-web-and-admin-panel\Wave Mall\lib\features\shop\view\shop_screen.dart", "Dart", 157, 0, 20, 177
"g:\codecanyon-PCAdfcae-SwiftTech-multivendor-ecommerce-complete-ecommerce-mobile-app-web-and-admin-panel\Wave Mall\lib\features\shop\widget\more_store_list_view.dart", "Dart", 33, 0, 4, 37
"g:\codecanyon-PCAdfcae-SwiftTech-multivendor-ecommerce-complete-ecommerce-mobile-app-web-and-admin-panel\Wave Mall\lib\features\shop\widget\seller_card.dart", "Dart", 139, 0, 24, 163
"g:\codecanyon-PCAdfcae-SwiftTech-multivendor-ecommerce-complete-ecommerce-mobile-app-web-and-admin-panel\Wave Mall\lib\features\shop\widget\shop_coupon_item_widget.dart", "Dart", 99, 0, 26, 125
"g:\codecanyon-PCAdfcae-SwiftTech-multivendor-ecommerce-complete-ecommerce-mobile-app-web-and-admin-panel\Wave Mall\lib\features\shop\widget\shop_featured_product_list_view.dart", "Dart", 41, 0, 4, 45
"g:\codecanyon-PCAdfcae-SwiftTech-multivendor-ecommerce-complete-ecommerce-mobile-app-web-and-admin-panel\Wave Mall\lib\features\shop\widget\shop_info_widget.dart", "Dart", 131, 0, 24, 155
"g:\codecanyon-PCAdfcae-SwiftTech-multivendor-ecommerce-complete-ecommerce-mobile-app-web-and-admin-panel\Wave Mall\lib\features\shop\widget\shop_product_view_list.dart", "Dart", 42, 0, 4, 46
"g:\codecanyon-PCAdfcae-SwiftTech-multivendor-ecommerce-complete-ecommerce-mobile-app-web-and-admin-panel\Wave Mall\lib\features\shop\widget\shop_recommanded_product_list.dart", "Dart", 41, 0, 4, 45
"g:\codecanyon-PCAdfcae-SwiftTech-multivendor-ecommerce-complete-ecommerce-mobile-app-web-and-admin-panel\Wave Mall\lib\features\shop\widget\top_seller_view.dart", "Dart", 78, 0, 17, 95
"g:\codecanyon-PCAdfcae-SwiftTech-multivendor-ecommerce-complete-ecommerce-mobile-app-web-and-admin-panel\Wave Mall\lib\features\splash\domain\model\config_model.dart", "Dart", 465, 0, 65, 530
"g:\codecanyon-PCAdfcae-SwiftTech-multivendor-ecommerce-complete-ecommerce-mobile-app-web-and-admin-panel\Wave Mall\lib\features\splash\domain\repo\splash_repo.dart", "Dart", 38, 0, 15, 53
"g:\codecanyon-PCAdfcae-SwiftTech-multivendor-ecommerce-complete-ecommerce-mobile-app-web-and-admin-panel\Wave Mall\lib\features\splash\provider\splash_provider.dart", "Dart", 93, 0, 17, 110
"g:\codecanyon-PCAdfcae-SwiftTech-multivendor-ecommerce-complete-ecommerce-mobile-app-web-and-admin-panel\Wave Mall\lib\features\splash\view\splash_screen.dart", "Dart", 108, 0, 13, 121
"g:\codecanyon-PCAdfcae-SwiftTech-multivendor-ecommerce-complete-ecommerce-mobile-app-web-and-admin-panel\Wave Mall\lib\features\splash\widget\splash_painter.dart", "Dart", 22, 0, 5, 27
"g:\codecanyon-PCAdfcae-SwiftTech-multivendor-ecommerce-complete-ecommerce-mobile-app-web-and-admin-panel\Wave Mall\lib\features\support\domain\model\support_reply_model.dart", "Dart", 31, 0, 5, 36
"g:\codecanyon-PCAdfcae-SwiftTech-multivendor-ecommerce-complete-ecommerce-mobile-app-web-and-admin-panel\Wave Mall\lib\features\support\domain\model\support_ticket_body.dart", "Dart", 30, 0, 5, 35
"g:\codecanyon-PCAdfcae-SwiftTech-multivendor-ecommerce-complete-ecommerce-mobile-app-web-and-admin-panel\Wave Mall\lib\features\support\domain\model\support_ticket_model.dart", "Dart", 70, 0, 5, 75
"g:\codecanyon-PCAdfcae-SwiftTech-multivendor-ecommerce-complete-ecommerce-mobile-app-web-and-admin-panel\Wave Mall\lib\features\support\domain\repo\support_ticket_repo.dart", "Dart", 77, 0, 11, 88
"g:\codecanyon-PCAdfcae-SwiftTech-multivendor-ecommerce-complete-ecommerce-mobile-app-web-and-admin-panel\Wave Mall\lib\features\support\domain\service\support_ticket_service.dart", "Dart", 2, 0, 1, 3
"g:\codecanyon-PCAdfcae-SwiftTech-multivendor-ecommerce-complete-ecommerce-mobile-app-web-and-admin-panel\Wave Mall\lib\features\support\domain\service\support_ticket_service_interface.dart", "Dart", 2, 0, 1, 3
"g:\codecanyon-PCAdfcae-SwiftTech-multivendor-ecommerce-complete-ecommerce-mobile-app-web-and-admin-panel\Wave Mall\lib\features\support\provider\support_ticket_provider.dart", "Dart", 115, 0, 21, 136
"g:\codecanyon-PCAdfcae-SwiftTech-multivendor-ecommerce-complete-ecommerce-mobile-app-web-and-admin-panel\Wave Mall\lib\features\support\view\add_ticket_screen.dart", "Dart", 152, 0, 19, 171
"g:\codecanyon-PCAdfcae-SwiftTech-multivendor-ecommerce-complete-ecommerce-mobile-app-web-and-admin-panel\Wave Mall\lib\features\support\view\support_conversation_screen.dart", "Dart", 151, 0, 27, 178
"g:\codecanyon-PCAdfcae-SwiftTech-multivendor-ecommerce-complete-ecommerce-mobile-app-web-and-admin-panel\Wave Mall\lib\features\support\view\support_ticket_screen.dart", "Dart", 60, 0, 8, 68
"g:\codecanyon-PCAdfcae-SwiftTech-multivendor-ecommerce-complete-ecommerce-mobile-app-web-and-admin-panel\Wave Mall\lib\features\support\widget\priority_bottom_sheet.dart", "Dart", 50, 0, 3, 53
"g:\codecanyon-PCAdfcae-SwiftTech-multivendor-ecommerce-complete-ecommerce-mobile-app-web-and-admin-panel\Wave Mall\lib\features\support\widget\support_ticket_item.dart", "Dart", 80, 0, 12, 92
"g:\codecanyon-PCAdfcae-SwiftTech-multivendor-ecommerce-complete-ecommerce-mobile-app-web-and-admin-panel\Wave Mall\lib\features\support\widget\support_ticket_shimmer.dart", "Dart", 45, 0, 4, 49
"g:\codecanyon-PCAdfcae-SwiftTech-multivendor-ecommerce-complete-ecommerce-mobile-app-web-and-admin-panel\Wave Mall\lib\features\support\widget\support_ticket_type_widget.dart", "Dart", 80, 0, 12, 92
"g:\codecanyon-PCAdfcae-SwiftTech-multivendor-ecommerce-complete-ecommerce-mobile-app-web-and-admin-panel\Wave Mall\lib\features\tracking\view\tracking_result_screen.dart", "Dart", 118, 0, 23, 141
"g:\codecanyon-PCAdfcae-SwiftTech-multivendor-ecommerce-complete-ecommerce-mobile-app-web-and-admin-panel\Wave Mall\lib\features\tracking\widget\line_dashed_painter.dart", "Dart", 23, 0, 5, 28
"g:\codecanyon-PCAdfcae-SwiftTech-multivendor-ecommerce-complete-ecommerce-mobile-app-web-and-admin-panel\Wave Mall\lib\features\wallet\domain\model\transaction_model.dart", "Dart", 138, 0, 12, 150
"g:\codecanyon-PCAdfcae-SwiftTech-multivendor-ecommerce-complete-ecommerce-mobile-app-web-and-admin-panel\Wave Mall\lib\features\wallet\domain\model\wallet_bonus_model.dart", "Dart", 53, 0, 9, 62
"g:\codecanyon-PCAdfcae-SwiftTech-multivendor-ecommerce-complete-ecommerce-mobile-app-web-and-admin-panel\Wave Mall\lib\features\wallet\domain\repo\wallet_repo.dart", "Dart", 42, 0, 5, 47
"g:\codecanyon-PCAdfcae-SwiftTech-multivendor-ecommerce-complete-ecommerce-mobile-app-web-and-admin-panel\Wave Mall\lib\features\wallet\domain\repo\wallet_repo_interface.dart", "Dart", 3, 0, 2, 5
"g:\codecanyon-PCAdfcae-SwiftTech-multivendor-ecommerce-complete-ecommerce-mobile-app-web-and-admin-panel\Wave Mall\lib\features\wallet\domain\service\wallet_service.dart", "Dart", 2, 0, 1, 3
"g:\codecanyon-PCAdfcae-SwiftTech-multivendor-ecommerce-complete-ecommerce-mobile-app-web-and-admin-panel\Wave Mall\lib\features\wallet\domain\service\wallet_service_interface.dart", "Dart", 2, 0, 2, 4
"g:\codecanyon-PCAdfcae-SwiftTech-multivendor-ecommerce-complete-ecommerce-mobile-app-web-and-admin-panel\Wave Mall\lib\features\wallet\provider\wallet_provider.dart", "Dart", 113, 0, 21, 134
"g:\codecanyon-PCAdfcae-SwiftTech-multivendor-ecommerce-complete-ecommerce-mobile-app-web-and-admin-panel\Wave Mall\lib\features\wallet\view\add_fund_digital_payment_screen.dart", "Dart", 221, 1, 47, 269
"g:\codecanyon-PCAdfcae-SwiftTech-multivendor-ecommerce-complete-ecommerce-mobile-app-web-and-admin-panel\Wave Mall\lib\features\wallet\view\wallet_screen.dart", "Dart", 198, 0, 43, 241
"g:\codecanyon-PCAdfcae-SwiftTech-multivendor-ecommerce-complete-ecommerce-mobile-app-web-and-admin-panel\Wave Mall\lib\features\wallet\widget\add_fund_dialogue.dart", "Dart", 111, 0, 13, 124
"g:\codecanyon-PCAdfcae-SwiftTech-multivendor-ecommerce-complete-ecommerce-mobile-app-web-and-admin-panel\Wave Mall\lib\features\wallet\widget\payment_radio_button.dart", "Dart", 77, 0, 6, 83
"g:\codecanyon-PCAdfcae-SwiftTech-multivendor-ecommerce-complete-ecommerce-mobile-app-web-and-admin-panel\Wave Mall\lib\features\wallet\widget\transaction_list_view.dart", "Dart", 51, 0, 11, 62
"g:\codecanyon-PCAdfcae-SwiftTech-multivendor-ecommerce-complete-ecommerce-mobile-app-web-and-admin-panel\Wave Mall\lib\features\wallet\widget\transaction_widget.dart", "Dart", 83, 0, 20, 103
"g:\codecanyon-PCAdfcae-SwiftTech-multivendor-ecommerce-complete-ecommerce-mobile-app-web-and-admin-panel\Wave Mall\lib\features\wallet\widget\wallet_card_widget.dart", "Dart", 63, 0, 6, 69
"g:\codecanyon-PCAdfcae-SwiftTech-multivendor-ecommerce-complete-ecommerce-mobile-app-web-and-admin-panel\Wave Mall\lib\features\wishlist\domain\model\wishlist_model.dart", "Dart", 158, 0, 12, 170
"g:\codecanyon-PCAdfcae-SwiftTech-multivendor-ecommerce-complete-ecommerce-mobile-app-web-and-admin-panel\Wave Mall\lib\features\wishlist\domain\repo\wishlist_repo.dart", "Dart", 32, 0, 6, 38
"g:\codecanyon-PCAdfcae-SwiftTech-multivendor-ecommerce-complete-ecommerce-mobile-app-web-and-admin-panel\Wave Mall\lib\features\wishlist\domain\service\wishlist_service.dart", "Dart", 2, 0, 1, 3
"g:\codecanyon-PCAdfcae-SwiftTech-multivendor-ecommerce-complete-ecommerce-mobile-app-web-and-admin-panel\Wave Mall\lib\features\wishlist\domain\service\wishlist_service_interface.dart", "Dart", 2, 0, 2, 4
"g:\codecanyon-PCAdfcae-SwiftTech-multivendor-ecommerce-complete-ecommerce-mobile-app-web-and-admin-panel\Wave Mall\lib\features\wishlist\provider\wishlist_provider.dart", "Dart", 73, 0, 12, 85
"g:\codecanyon-PCAdfcae-SwiftTech-multivendor-ecommerce-complete-ecommerce-mobile-app-web-and-admin-panel\Wave Mall\lib\features\wishlist\view\wishlist_screen.dart", "Dart", 89, 0, 12, 101
"g:\codecanyon-PCAdfcae-SwiftTech-multivendor-ecommerce-complete-ecommerce-mobile-app-web-and-admin-panel\Wave Mall\lib\features\wishlist\widget\wishlist_widget.dart", "Dart", 129, 0, 21, 150
"g:\codecanyon-PCAdfcae-SwiftTech-multivendor-ecommerce-complete-ecommerce-mobile-app-web-and-admin-panel\Wave Mall\lib\helper\api_checker.dart", "Dart", 27, 1, 2, 30
"g:\codecanyon-PCAdfcae-SwiftTech-multivendor-ecommerce-complete-ecommerce-mobile-app-web-and-admin-panel\Wave Mall\lib\helper\custom_delegate.dart", "Dart", 9, 0, 1, 10
"g:\codecanyon-PCAdfcae-SwiftTech-multivendor-ecommerce-complete-ecommerce-mobile-app-web-and-admin-panel\Wave Mall\lib\helper\date_converter.dart", "Dart", 75, 1, 25, 101
"g:\codecanyon-PCAdfcae-SwiftTech-multivendor-ecommerce-complete-ecommerce-mobile-app-web-and-admin-panel\Wave Mall\lib\helper\email_checker.dart", "Dart", 5, 0, 0, 5
"g:\codecanyon-PCAdfcae-SwiftTech-multivendor-ecommerce-complete-ecommerce-mobile-app-web-and-admin-panel\Wave Mall\lib\helper\json_converter.dart", "Dart", 1, 0, 1, 2
"g:\codecanyon-PCAdfcae-SwiftTech-multivendor-ecommerce-complete-ecommerce-mobile-app-web-and-admin-panel\Wave Mall\lib\helper\network_info.dart", "Dart", 49, 1, 6, 56
"g:\codecanyon-PCAdfcae-SwiftTech-multivendor-ecommerce-complete-ecommerce-mobile-app-web-and-admin-panel\Wave Mall\lib\helper\price_converter.dart", "Dart", 41, 0, 5, 46
"g:\codecanyon-PCAdfcae-SwiftTech-multivendor-ecommerce-complete-ecommerce-mobile-app-web-and-admin-panel\Wave Mall\lib\helper\product_type.dart", "Dart", 11, 0, 0, 11
"g:\codecanyon-PCAdfcae-SwiftTech-multivendor-ecommerce-complete-ecommerce-mobile-app-web-and-admin-panel\Wave Mall\lib\helper\velidate_check.dart", "Dart", 43, 0, 3, 46
"g:\codecanyon-PCAdfcae-SwiftTech-multivendor-ecommerce-complete-ecommerce-mobile-app-web-and-admin-panel\Wave Mall\lib\interface\repo_interface.dart", "Dart", 9, 15, 12, 36
"g:\codecanyon-PCAdfcae-SwiftTech-multivendor-ecommerce-complete-ecommerce-mobile-app-web-and-admin-panel\Wave Mall\lib\localization\app_localization.dart", "Dart", 40, 0, 13, 53
"g:\codecanyon-PCAdfcae-SwiftTech-multivendor-ecommerce-complete-ecommerce-mobile-app-web-and-admin-panel\Wave Mall\lib\localization\language_constrants.dart", "Dart", 5, 0, 1, 6
"g:\codecanyon-PCAdfcae-SwiftTech-multivendor-ecommerce-complete-ecommerce-mobile-app-web-and-admin-panel\Wave Mall\lib\localization\model\language_model.dart", "Dart", 7, 0, 2, 9
"g:\codecanyon-PCAdfcae-SwiftTech-multivendor-ecommerce-complete-ecommerce-mobile-app-web-and-admin-panel\Wave Mall\lib\localization\provider\localization_provider.dart", "Dart", 53, 0, 9, 62
"g:\codecanyon-PCAdfcae-SwiftTech-multivendor-ecommerce-complete-ecommerce-mobile-app-web-and-admin-panel\Wave Mall\lib\main.dart", "Dart", 154, 0, 14, 168
"g:\codecanyon-PCAdfcae-SwiftTech-multivendor-ecommerce-complete-ecommerce-mobile-app-web-and-admin-panel\Wave Mall\lib\push_notification\model\notification_body.dart", "Dart", 18, 0, 9, 27
"g:\codecanyon-PCAdfcae-SwiftTech-multivendor-ecommerce-complete-ecommerce-mobile-app-web-and-admin-panel\Wave Mall\lib\push_notification\notification_helper.dart", "Dart", 161, 21, 21, 203
"g:\codecanyon-PCAdfcae-SwiftTech-multivendor-ecommerce-complete-ecommerce-mobile-app-web-and-admin-panel\Wave Mall\lib\theme\dark_theme.dart", "Dart", 29, 0, 3, 32
"g:\codecanyon-PCAdfcae-SwiftTech-multivendor-ecommerce-complete-ecommerce-mobile-app-web-and-admin-panel\Wave Mall\lib\theme\light_theme.dart", "Dart", 26, 0, 4, 30
"g:\codecanyon-PCAdfcae-SwiftTech-multivendor-ecommerce-complete-ecommerce-mobile-app-web-and-admin-panel\Wave Mall\lib\theme\provider\theme_provider.dart", "Dart", 20, 0, 5, 25
"g:\codecanyon-PCAdfcae-SwiftTech-multivendor-ecommerce-complete-ecommerce-mobile-app-web-and-admin-panel\Wave Mall\lib\utill\app_constants.dart", "Dart", 172, 3, 14, 189
"g:\codecanyon-PCAdfcae-SwiftTech-multivendor-ecommerce-complete-ecommerce-mobile-app-web-and-admin-panel\Wave Mall\lib\utill\color_resources.dart", "Dart", 129, 0, 14, 143
"g:\codecanyon-PCAdfcae-SwiftTech-multivendor-ecommerce-complete-ecommerce-mobile-app-web-and-admin-panel\Wave Mall\lib\utill\custom_themes.dart", "Dart", 59, 0, 9, 68
"g:\codecanyon-PCAdfcae-SwiftTech-multivendor-ecommerce-complete-ecommerce-mobile-app-web-and-admin-panel\Wave Mall\lib\utill\dimensions.dart", "Dart", 48, 0, 11, 59
"g:\codecanyon-PCAdfcae-SwiftTech-multivendor-ecommerce-complete-ecommerce-mobile-app-web-and-admin-panel\Wave Mall\lib\utill\images.dart", "Dart", 184, 0, 7, 191
"Total", "-", 35421, 373, 5905, 41699